AAAAACCGGCG -> AAAACCGGCGG
AAAAATCACCG -> AAAATCACCGG
AAAAATGCCTT -> AAAATGCCTTG
AAAACCGGCGG -> AAACCGGCGGT
AAAATCACCGG -> AAATCACCGGA
AAAATCTTCGC -> AAATCTTCGCA
AAAATGCCTTG -> AAATGCCTTGT
AAAATTGCCGA -> AAATTGCCGAA
AAACACCGACG -> AACACCGACGT
AAACACTTAGC -> AACACTTAGCG
AAACAGGTCGA -> AACAGGTCGAG
AAACCACTCTA -> AACCACTCTAA
AAACCAGTTGG -> AACCAGTTGGC
AAACCGGCGGT -> AACCGGCGGTA
AAACCTCTTCG -> AACCTCTTCGC
AAAGACAGCAG -> AAGACAGCAGT
AAAGAGGGTTA -> AAGAGGGTTAC
AAAGCACTTTC -> AAGCACTTTCG
AAAGCATCCCG -> AAGCATCCCGG
AAAGCGACATC -> AAGCGACATCT
AAAGCGTAATC -> AAGCGTAATCC
AAAGGCGCCCC -> AAGGCGCCCCT
AAAGGCGTCCG -> AAGGCGTCCGT
AAAGGTTGATG -> AAGGTTGATGA
AAAGTGCTATC -> AAGTGCTATCG
AAAGTTGCGCG -> AAGTTGCGCGA
AAATCACCGGA -> AATCACCGGAT
AAATCTAAACA -> AATCTAAACAC
AAATCTTCGCA -> AATCTTCGCAT
AAATGACGGGG -> AATGACGGGGG
AAATGCCTTGT -> AATGCCTTGTG
AAATGCGACTA -> AATGCGACTAC
AAATGGGCCCT -> AATGGGCCCTG
AAATTGCCGAA -> AATTGCCGAAT
AACAATGCTTA -> ACAATGCTTAG
AACACCGACGT -> ACACCGACGTA
AACACTTAGCG -> ACACTTAGCGA
AACAGGTCGAG -> ACAGGTCGAGA
AACATAATGAT -> ACATAATGATA
AACATTGGGCC -> ACATTGGGCCC
AACCACTCTAA -> ACCACTCTAAG
AACCACTTCCC -> ACCACTTCCCC
AACCAGTTGGC -> ACCAGTTGGCC
AACCCCAACGT -> ACCCCAACGTA
AACCCCTCTGT -> ACCCCTCTGTT
AACCGACATGT -> ACCGACATGTT
AACCGGCGGTA -> ACCGGCGGTAT
AACCTCTATTC -> ACCTCTATTCC
AACCTCTTCGC -> ACCTCTTCGCA
AACGATATCCG -> ACGATATCCGT
AACGATCTACT -> ACGATCTACTT
AACGCCACTTC -> ACGCCACTTCA
AACGCGACACT -> ACGCGACACTT
AACGCGAGTGT -> ACGCGAGTGTG
AACGGCACCCA -> ACGGCACCCAT
AACGTATAAAA -> ACGTATAAAAA
AACGTATAGGG -> ACGTATAGGGC
AACTAATGGCA -> ACTAATGGCAA
AACTGAAATGA -> ACTGAAATGAC
AAGAAATGGGC -> AGAAATGGGCC
AAGACAGCAGT -> AGACAGCAGTA
AAGAGGGAACC -> AGAGGGAACCT
AAGAGGGTTAC -> AGAGGGTTACT
AAGATAAAGTG -> AGATAAAGTGC
AAGATAAGGAT -> AGATAAGGATT
AAGATGACCAG -> AGATGACCAGC
AAGCACCTGTG -> AGCACCTGTGA
AAGCACTTTCG -> AGCACTTTCGC
AAGCATCCCGG -> AGCATCCCGGT
AAGCCTCACGA -> AGCCTCACGAA
AAGCGACATCT -> AGCGACATCTA
AAGCGTAATCC -> AGCGTAATCCC
AAGGAGTTAGG -> AGGAGTTAGGG
AAGGATATTTT -> AGGATATTTTC
AAGGATTATGG -> AGGATTATGGA
AAGGCGCCCCT -> AGGCGCCCCTC
AAGGCGTCCGT -> AGGCGTCCGTT
AAGGTGCTATA -> AGGTGCTATAC
AAGGTGTGAGG -> AGGTGTGAGGC
AAGGTTGATGA -> AGGTTGATGAC
AAGTAGCATTA -> AGTAGCATTAG
AAGTAGGCCAC -> AGTAGGCCACA
AAGTCAGTCGA -> AGTCAGTCGAG
AAGTCCCGTAC -> AGTCCCGTACT
AAGTGCTATCG -> AGTGCTATCGC
AAGTGTCAGTG -> AGTGTCAGTGA
AAGTTGCGCGA -> AGTTGCGCGAA
AATAAACCAGT -> ATAAACCAGTT
AATACTATCTA -> ATACTATCTAA
AATATCGGGTT -> ATATCGGGTTG
AATCACCGGAT -> ATCACCGGATA
AATCCATTAGT -> ATCCATTAGTA
AATCCCATCAC -> ATCCCATCACG
AATCTAAACAC -> ATCTAAACACT
AATCTCGAGCA -> ATCTCGAGCAT
AATCTCGAGTT -> ATCTCGAGTTG
AATCTGCCTCG -> ATCTGCCTCGT
AATCTTCGCAT -> ATCTTCGCATT
AATCTTCTTTC -> ATCTTCTTTCC
AATGACGGGGG -> ATGACGGGGGG
AATGATAACCA -> ATGATAACCAC
AATGCCTTGTG -> ATGCCTTGTGT
AATGCGACTAC -> ATGCGACTACC
AATGCTTAGTC -> ATGCTTAGTCA
AATGGCAAGGA -> ATGGCAAGGAG
AATGGGCCCTG -> ATGGGCCCTGC
AATTACCCTTA -> ATTACCCTTAG
AATTCACAGTG -> ATTCACAGTGG
AATTCGACCAG -> ATTCGACCAGT
AATTCGTCGCC -> ATTCGTCGCCC
AATTGCCGAAT -> ATTGCCGAATC
AATTTGGCACG -> ATTTGGCACGT
ACAAATCTAAA -> CAAATCTAAAC
ACAACGCGAGT -> CAACGCGAGTG
ACAAGATAAAG -> CAAGATAAAGT
ACAAGTGTCAG -> CAAGTGTCAGT
ACAATGCTTAG -> CAATGCTTAGT
ACACCACAAGA -> CACCACAAGAT
ACACCCGTAAA -> CACCCGTAAAA
ACACCGACGTA -> CACCGACGTAC
ACACGTGACCC -> CACGTGACCCG
ACACTGGACGA -> CACTGGACGAC
ACACTTAGCAG -> CACTTAGCAGG
ACACTTAGCGA -> CACTTAGCGAC
ACAGATGTTCC -> CAGATGTTCCA
ACAGCAGTAGA -> CAGCAGTAGAG
ACAGCATCGAC -> CAGCATCGACC
ACAGCGGGGTG -> CAGCGGGGTGC
ACAGGAAGGAT -> CAGGAAGGATA
ACAGGTCGAGA -> CAGGTCGAGAT
ACAGTGATACC -> CAGTGATACCT
ACAGTGGAAAG -> CAGTGGAAAGA
ACAGTTTCCTA -> CAGTTTCCTAT
ACATAATGATA -> CATAATGATAA
ACATATGTGTG -> CATATGTGTGC
ACATCACCCTC -> CATCACCCTCA
ACATCCCCGGG -> CATCCCCGGGA
ACATCTAGAAC -> CATCTAGAACG
ACATGTTATGA -> CATGTTATGAG
ACATTGACTGG -> CATTGACTGGT
ACATTGGGCCC -> CATTGGGCCCA
ACCAAACAGGT -> CCAAACAGGTC
ACCAACCGACA -> CCAACCGACAT
ACCAAGCCTCA -> CCAAGCCTCAC
ACCACAAGATA -> CCACAAGATAA
ACCACATTGAC -> CCACATTGACT
ACCACGCTCGT -> CCACGCTCGTG
ACCACTCTAAG -> CCACTCTAAGT
ACCACTTCCCC -> CCACTTCCCCG
ACCAGCCGAAA -> CCAGCCGAAAA
ACCAGGGAATC -> CCAGGGAATCT
ACCAGTGCTCG -> CCAGTGCTCGG
ACCAGTGGCCG -> CCAGTGGCCGG
ACCAGTTGGCC -> CCAGTTGGCCA
ACCCATTATTG -> CCCATTATTGT
ACCCCAACGTA -> CCCCAACGTAT
ACCCCTCTGTT -> CCCCTCTGTTT
ACCCCTTGCCG -> CCCCTTGCCGG
ACCCGGGTCTA -> CCCGGGTCTAG
ACCCGTAAAAA -> CCCGTAAAAAT
ACCCTAAGCAC -> CCCTAAGCACC
ACCCTATTTAC -> CCCTATTTACA
ACCCTCAGATT -> CCCTCAGATTT
ACCCTGGCCTG -> CCCTGGCCTGA
ACCCTTAGTAG -> CCCTTAGTAGA
ACCGACATGTT -> CCGACATGTTA
ACCGACGTACG -> CCGACGTACGC
ACCGGATAGTA -> CCGGATAGTAC
ACCGGCGGTAT -> CCGGCGGTATC
ACCGTAGAGTC -> CCGTAGAGTCA
ACCGTCAAACC -> CCGTCAAACCA
ACCGTGCGGCG -> CCGTGCGGCGG
ACCTCCTTTAG -> CCTCCTTTAGA
ACCTCTATTCC -> CCTCTATTCCA
ACCTCTTCGCA -> CCTCTTCGCAC
ACCTGTGAATA -> CCTGTGAATAT
ACCTTAACTGA -> CCTTAACTGAA
ACCTTAGAGCG -> CCTTAGAGCGA
ACGAACATAAT -> CGAACATAATG
ACGACATATGT -> CGACATATGTG
ACGACATCACC -> CGACATCACCC
ACGACCACATT -> CGACCACATTG
ACGACTCTAAG -> CGACTCTAAGA
ACGAGCTACAG -> CGAGCTACAGC
ACGATATCCGT -> CGATATCCGTC
ACGATCTACTT -> CGATCTACTTG
ACGCACCAAGC -> CGCACCAAGCC
ACGCAGGCCTC -> CGCAGGCCTCT
ACGCCACTTCA -> CGCCACTTCAG
ACGCCGCACAA -> CGCCGCACAAC
ACGCGACACTT -> CGCGACACTTA
ACGCGAGTGTG -> CGCGAGTGTGA
ACGCGCTCGAG -> CGCGCTCGAGG
ACGCTCAAGTA -> CGCTCAAGTAG
ACGCTCGTGCC -> CGCTCGTGCCT
ACGCTTCAAAG -> CGCTTCAAAGC
ACGGCACCCAT -> CGGCACCCATT
ACGGCCTGAGC -> CGGCCTGAGCC
ACGGGGGGGCG -> CGGGGGGGCGA
ACGGTGTATAG -> CGGTGTATAGG
ACGGTTTTCCA -> CGGTTTTCCAG
ACGTAACTAAT -> CGTAACTAATG
ACGTACCAGTG -> CGTACCAGTGG
ACGTACGCTTC -> CGTACGCTTCA
ACGTAGAGGGG -> CGTAGAGGGGT
ACGTATAAAAA -> CGTATAAAAAT
ACGTATAGGGC -> CGTATAGGGCA
ACGTGACCCGG -> CGTGACCCGGG
ACGTTCATGCA -> CGTTCATGCAA
ACGTTTTTCGT -> CGTTTTTCGTA
ACTAATCCATT -> CTAATCCATTA
ACTAATGGCAA -> CTAATGGCAAG
ACTACCGTAGA -> CTACCGTAGAG
ACTACCGTGCG -> CTACCGTGCGG
ACTACTATCTT -> CTACTATCTTC
ACTATCTAAAT -> CTATCTAAATG
ACTATCTTCAT -> CTATCTTCATG
ACTCAAAGGCG -> CTCAAAGGCGC
ACTCTAAGATA -> CTCTAAGATAA
ACTCTAAGTCA -> CTCTAAGTCAG
ACTCTACTACC -> CTCTACTACCG
ACTGAAAGGCG -> CTGAAAGGCGT
ACTGAAATGAC -> CTGAAATGACG
ACTGAATTCGT -> CTGAATTCGTC
ACTGCTGGCTC -> CTGCTGGCTCT
ACTGGACGACA -> CTGGACGACAT
ACTGGTGCGTT -> CTGGTGCGTTA
ACTGTTGACGA -> CTGTTGACGAC
ACTGTTTCATC -> CTGTTTCATCA
ACTTAGCAGGT -> CTTAGCAGGTA
ACTTAGCGACA -> CTTAGCGACAG
ACTTCAGGGCG -> CTTCAGGGCGA
ACTTCCCCGAC -> CTTCCCCGACC
ACTTCGGACGA -> CTTCGGACGAG
ACTTGGGCAAT -> CTTGGGCAATT
ACTTGGTCCGG -> CTTGGTCCGGT
ACTTTCGCGTG -> CTTTCGCGTGA
AGAAACACCGA -> GAAACACCGAC
AGAAATGGGCC -> GAAATGGGCCC
AGAACATTGGG -> GAACATTGGGC
AGAACGTATAA -> GAACGTATAAA
AGAAGATGACC -> GAAGATGACCA
AGAAGGTGCTA -> GAAGGTGCTAT
AGAATTACCCT -> GAATTACCCTT
AGACAGCAGTA -> GACAGCAGTAG
AGACATCCCCG -> GACATCCCCGG
AGACCCTAAGC -> GACCCTAAGCA
AGACGCGCTCG -> GACGCGCTCGA
AGACGTACCAG -> GACGTACCAGT
AGACTTCGGAC -> GACTTCGGACG
AGAGAACATTG -> GAGAACATTGG
AGAGAAGGTGC -> GAGAAGGTGCT
AGAGACATCCC -> GAGACATCCCC
AGAGAGAACAT -> GAGAGAACATT
AGAGCCAACCC -> GAGCCAACCCC
AGAGCGACTTG -> GAGCGACTTGG
AGAGGGAACCT -> GAGGGAACCTC
AGAGGGGTACC -> GAGGGGTACCT
AGAGGGTTACT -> GAGGGTTACTC
AGAGGTTCGTG -> GAGGTTCGTGC
AGAGTCAAAGC -> GAGTCAAAGCG
AGAGTCCTGAC -> GAGTCCTGACT
AGAGTTCCGAT -> GAGTTCCGATT
AGATAAAGTGC -> GATAAAGTGCT
AGATAAAGTTG -> GATAAAGTTGC
AGATAAGGATT -> GATAAGGATTA
AGATGACCAGC -> GATGACCAGCC
AGATGAGAAAC -> GATGAGAAACA
AGATGATGAAG -> GATGATGAAGT
AGATGGGTTAG -> GATGGGTTAGT
AGATGTTCCAA -> GATGTTCCAAC
AGATTGGTAGG -> GATTGGTAGGC
AGATTTCTCGC -> GATTTCTCGCA
AGCAACGCCAC -> GCAACGCCACT
AGCACCTGTGA -> GCACCTGTGAA
AGCACGCCGCA -> GCACGCCGCAC
AGCACTTTCGC -> GCACTTTCGCG
AGCAGGGTTGA -> GCAGGGTTGAA
AGCAGGTACCC -> GCAGGTACCCC
AGCAGTAGAGA -> GCAGTAGAGAC
AGCATACGTAA -> GCATACGTAAC
AGCATCCCGGT -> GCATCCCGGTG
AGCATCGACCA -> GCATCGACCAC
AGCATGGCTCT -> GCATGGCTCTA
AGCATGTGGCC -> GCATGTGGCCT
AGCATTAGTAC -> GCATTAGTACA
AGCATTGTATC -> GCATTGTATCG
AGCCAACCCCA -> GCCAACCCCAA
AGCCCAGACGC -> GCCCAGACGCG
AGCCCGACCTC -> GCCCGACCTCC
AGCCGAAAATC -> GCCGAAAATCT
AGCCTCACGAA -> GCCTCACGAAC
AGCCTGTCCCG -> GCCTGTCCCGC
AGCCTGTCCTT -> GCCTGTCCTTA
AGCGACAGGAA -> GCGACAGGAAG
AGCGACATCTA -> GCGACATCTAG
AGCGACTTGGT -> GCGACTTGGTC
AGCGGAGGCAC -> GCGGAGGCACC
AGCGGGGTGCA -> GCGGGGTGCAA
AGCGTAATCCC -> GCGTAATCCCA
AGCGTCTTGGG -> GCGTCTTGGGA
AGCTACAGCAT -> GCTACAGCATC
AGCTCCCAGCG -> GCTCCCAGCGG
AGCTCTTCAGT -> GCTCTTCAGTG
AGCTTCTGCTA -> GCTTCTGCTAG
AGCTTGGTTAT -> GCTTGGTTATG
AGGAAGGATAT -> GGAAGGATATT
AGGAGTAAAGC -> GGAGTAAAGCG
AGGAGTTAGGG -> GGAGTTAGGGT
AGGATATTTTC -> GGATATTTTCA
AGGATTATGGA -> GGATTATGGAT
AGGCACCGTCA -> GGCACCGTCAA
AGGCAGCTTCT -> GGCAGCTTCTG
AGGCATAGACT -> GGCATAGACTT
AGGCCACAGTT -> GGCCACAGTTT
AGGCCGATTGA -> GGCCGATTGAG
AGGCCTCTAGA -> GGCCTCTAGAG
AGGCGCACTTT -> GGCGCACTTTA
AGGCGCCCCTC -> GGCGCCCCTCT
AGGCGCCTGAT -> GGCGCCTGATA
AGGCGTCCGTT -> GGCGTCCGTTT
AGGCTGGGCAA -> GGCTGGGCAAT
AGGGAAAAACC -> GGGAAAAACCG
AGGGAACCTCT -> GGGAACCTCTA
AGGGAATCTGC -> GGGAATCTGCC
AGGGCAGCAGG -> GGGCAGCAGGG
AGGGCGAAACC -> GGGCGAAACCT
AGGGGTACCTT -> GGGGTACCTTA
AGGGTACACTG -> GGGTACACTGG
AGGGTGGGAGA -> GGGTGGGAGAT
AGGGTTACTCT -> GGGTTACTCTA
AGGGTTGAAGT -> GGGTTGAAGTA
AGGTACCCCTT -> GGTACCCCTTG
AGGTCGAGATG -> GGTCGAGATGA
AGGTGCTATAC -> GGTGCTATACA
AGGTGTCACGG -> GGTGTCACGGC
AGGTGTGAGGC -> GGTGTGAGGCA
AGGTTCGTGCG -> GGTTCGTGCGG
AGGTTGATGAC -> GGTTGATGACA
AGTAAAGCGAC -> GTAAAGCGACA
AGTACACCCGT -> GTACACCCGTA
AGTACTGAAAG -> GTACTGAAAGG
AGTAGAGAAGG -> GTAGAGAAGGT
AGTAGAGACAT -> GTAGAGACATC
AGTAGCATTAG -> GTAGCATTAGT
AGTAGGCCACA -> GTAGGCCACAG
AGTATAGAGGT -> GTATAGAGGTT
AGTCAAAGCGT -> GTCAAAGCGTA
AGTCAGAGTCC -> GTCAGAGTCCT
AGTCAGTCGAG -> GTCAGTCGAGC
AGTCCCAGAGA -> GTCCCAGAGAG
AGTCCCGTACT -> GTCCCGTACTC
AGTCCTGACTG -> GTCCTGACTGT
AGTCGAGCCCA -> GTCGAGCCCAG
AGTCGCTTGAG -> GTCGCTTGAGA
AGTCGTGTAAC -> GTCGTGTAACC
AGTGACGGTGT -> GTGACGGTGTA
AGTGAGGTGTC -> GTGAGGTGTCA
AGTGATACCTT -> GTGATACCTTA
AGTGCTATCGC -> GTGCTATCGCG
AGTGCTCGGCG -> GTGCTCGGCGA
AGTGGAAAGAC -> GTGGAAAGACA
AGTGGCCGGTA -> GTGGCCGGTAC
AGTGTCAGTGA -> GTGTCAGTGAG
AGTGTGAGATT -> GTGTGAGATTG
AGTTAGGGTAC -> GTTAGGGTACA
AGTTCATCTTG -> GTTCATCTTGG
AGTTCCGATTA -> GTTCCGATTAA
AGTTGCGCGAA -> GTTGCGCGAAG
AGTTGCGCGAG -> GTTGCGCGAGC
AGTTGGCCAAA -> GTTGGCCAAAA
AGTTGTCTCCT -> GTTGTCTCCTC
AGTTGTTTCAA -> GTTGTTTCAAT
AGTTTCCTATT -> GTTTCCTATTG
ATAAAAATGCC -> TAAAAATGCCT
ATAAACCAGTT -> TAAACCAGTTG
ATAAAGTGCTA -> TAAAGTGCTAT
ATAAAGTTGCG -> TAAAGTTGCGC
ATAACCACTTC -> TAACCACTTCC
ATAAGGATTAT -> TAAGGATTATG
ATAATGATAAC -> TAATGATAACC
ATACAAATCTA -> TACAAATCTAA
ATACCTTAACT -> TACCTTAACTG
ATACGTAACTA -> TACGTAACTAA
ATACTATCTAA -> TACTATCTAAA
ATAGACTTCGG -> TAGACTTCGGA
ATAGAGGTTCG -> TAGAGGTTCGT
ATAGCAACGCC -> TAGCAACGCCA
ATAGCCTGTCC -> TAGCCTGTCCT
ATAGGCATAGA -> TAGGCATAGAC
ATAGGCGCACT -> TAGGCGCACTT
ATAGGGCAGCA -> TAGGGCAGCAG
ATAGTACTGAA -> TAGTACTGAAA
ATATCCGTCCG -> TATCCGTCCGA
ATATCGGACGA -> TATCGGACGAC
ATATCGGGTTG -> TATCGGGTTGT
ATATGCGGTGC -> TATGCGGTGCG
ATATGTAGATG -> TATGTAGATGG
ATATGTGTGCC -> TATGTGTGCCC
ATATTTTCAGT -> TATTTTCAGTC
ATCACCCTCAG -> TCACCCTCAGA
ATCACCGGATA -> TCACCGGATAG
ATCACGCTCAA -> TCACGCTCAAG
ATCACGTTTTT -> TCACGTTTTTC
ATCACTAATCC -> TCACTAATCCA
ATCAGGGAAAA -> TCAGGGAAAAA
ATCCATTAGTA -> TCCATTAGTAT
ATCCCATCACG -> TCCCATCACGT
ATCCCCGGGAG -> TCCCCGGGAGA
ATCCCGGTGGG -> TCCCGGTGGGT
ATCCGTCCGAT -> TCCGTCCGATA
ATCGACCACGC -> TCGACCACGCT
ATCGCGTTAAT -> TCGCGTTAATA
ATCGGACGACA -> TCGGACGACAT
ATCGGGATTGA -> TCGGGATTGAG
ATCGGGTTGTC -> TCGGGTTGTCC
ATCGTCCGCGA -> TCGTCCGCGAG
ATCTAAACACT -> TCTAAACACTT
ATCTAAATGCG -> TCTAAATGCGA
ATCTACTTGGG -> TCTACTTGGGC
ATCTAGAACGT -> TCTAGAACGTA
ATCTCGAGCAT -> TCTCGAGCATG
ATCTCGAGTTG -> TCTCGAGTTGT
ATCTCGGGCCG -> TCTCGGGCCGC
ATCTGCCTCGT -> TCTGCCTCGTG
ATCTTCATGAC -> TCTTCATGACG
ATCTTCGCATT -> TCTTCGCATTA
ATCTTCTTTCC -> TCTTCTTTCCA
ATCTTGGTTAA -> TCTTGGTTAAA
ATGAAGTCCCG -> TGAAGTCCCGT
ATGACACGTGA -> TGACACGTGAC
ATGACCAGCCG -> TGACCAGCCGA
ATGACGGGGGG -> TGACGGGGGGG
ATGACGTAGAG -> TGACGTAGAGG
ATGACTGAATT -> TGACTGAATTC
ATGAGAAACAC -> TGAGAAACACC
ATGAGTTCATC -> TGAGTTCATCT
ATGATAACCAC -> TGATAACCACT
ATGATGAAGTC -> TGATGAAGTCC
ATGCAATCTCG -> TGCAATCTCGA
ATGCCTTGTGT -> TGCCTTGTGTA
ATGCGACTACC -> TGCGACTACCG
ATGCGGTGCGA -> TGCGGTGCGAT
ATGCTTAGTCA -> TGCTTAGTCAG
ATGGAGGGTGG -> TGGAGGGTGGG
ATGGATTGTTT -> TGGATTGTTTC
ATGGCAAGGAG -> TGGCAAGGAGT
ATGGCTCTACG -> TGGCTCTACGA
ATGGGCCCTGC -> TGGGCCCTGCT
ATGGGTTAGTC -> TGGGTTAGTCC
ATGTAGATGGG -> TGTAGATGGGT
ATGTCTGTTGT -> TGTCTGTTGTA
ATGTGGCCTGC -> TGTGGCCTGCG
ATGTGTGCCCT -> TGTGTGCCCTG
ATGTTATGAGT -> TGTTATGAGTT
ATGTTCCAACG -> TGTTCCAACGG
ATGTTGCGACC -> TGTTGCGACCA
ATTAACGATCT -> TTAACGATCTA
ATTAAGAAATG -> TTAAGAAATGG
ATTACAGATGT -> TTACAGATGTT
ATTACCCTTAG -> TTACCCTTAGT
ATTAGTACACC -> TTAGTACACCC
ATTAGTATAGA -> TTAGTATAGAG
ATTATGGATTG -> TTATGGATTGT
ATTATTGTCAC -> TTATTGTCACG
ATTCAAAGAGG -> TTCAAAGAGGG
ATTCACAGTGG -> TTCACAGTGGA
ATTCATGACTG -> TTCATGACTGA
ATTCCACTGCT -> TTCCACTGCTG
ATTCGACCAGT -> TTCGACCAGTG
ATTCGTCGCCC -> TTCGTCGCCCA
ATTGACTGGTG -> TTGACTGGTGC
ATTGAGAAGAT -> TTGAGAAGATG
ATTGAGTTGCG -> TTGAGTTGCGC
ATTGATCACTA -> TTGATCACTAA
ATTGCCGAATC -> TTGCCGAATCT
ATTGGGCCCAC -> TTGGGCCCACT
ATTGGTAGGCC -> TTGGTAGGCCG
ATTGTATCGGG -> TTGTATCGGGA
ATTGTCACGCA -> TTGTCACGCAC
ATTGTTTCCGT -> TTGTTTCCGTG
ATTTACAGCGG -> TTTACAGCGGG
ATTTCTCGCAT -> TTTCTCGCATA
ATTTGGCACGT -> TTTGGCACGTT
ATTTTCAGTCG -> TTTTCAGTCGC
CAAAATTGCCG -> AAAATTGCCGA
CAAACAGGTCG -> AAACAGGTCGA
CAAACCACTCT -> AAACCACTCTA
CAAAGAGGGTT -> AAAGAGGGTTA
CAAAGCACTTT -> AAAGCACTTTC
CAAAGCATCCC -> AAAGCATCCCG
CAAAGCGTAAT -> AAAGCGTAATC
CAAAGGCGCCC -> AAAGGCGCCCC
CAAATCTAAAC -> AAATCTAAACA
CAACAATGCTT -> AACAATGCTTA
CAACCCCAACG -> AACCCCAACGT
CAACCGACATG -> AACCGACATGT
CAACGCCACTT -> AACGCCACTTC
CAACGCGAGTG -> AACGCGAGTGT
CAACGGCACCC -> AACGGCACCCA
CAACGTATAGG -> AACGTATAGGG
CAAGATAAAGT -> AAGATAAAGTG
CAAGCCTCACG -> AAGCCTCACGA
CAAGGAGTTAG -> AAGGAGTTAGG
CAAGTAGGCCA -> AAGTAGGCCAC
CAAGTGTCAGT -> AAGTGTCAGTG
CAATAAACCAG -> AATAAACCAGT
CAATCTCGAGC -> AATCTCGAGCA
CAATCTCGAGT -> AATCTCGAGTT
CAATGCTTAGT -> AATGCTTAGTC
CAATTCACAGT -> AATTCACAGTG
CAATTCGACCA -> AATTCGACCAG
CACAACGCGAG -> ACAACGCGAGT
CACAAGATAAA -> ACAAGATAAAG
CACAGTGATAC -> ACAGTGATACC
CACAGTGGAAA -> ACAGTGGAAAG
CACAGTTTCCT -> ACAGTTTCCTA
CACATTGACTG -> ACATTGACTGG
CACCAAACAGG -> ACCAAACAGGT
CACCAAGCCTC -> ACCAAGCCTCA
CACCACAAGAT -> ACCACAAGATA
CACCCATTATT -> ACCCATTATTG
CACCCGTAAAA -> ACCCGTAAAAA
CACCCTCAGAT -> ACCCTCAGATT
CACCGACGTAC -> ACCGACGTACG
CACCGGATAGT -> ACCGGATAGTA
CACCGTCAAAC -> ACCGTCAAACC
CACCTGTGAAT -> ACCTGTGAATA
CACGAACATAA -> ACGAACATAAT
CACGCACCAAG -> ACGCACCAAGC
CACGCAGGCCT -> ACGCAGGCCTC
CACGCCGCACA -> ACGCCGCACAA
CACGCTCAAGT -> ACGCTCAAGTA
CACGCTCGTGC -> ACGCTCGTGCC
CACGGCCTGAG -> ACGGCCTGAGC
CACGGTTTTCC -> ACGGTTTTCCA
CACGTGACCCG -> ACGTGACCCGG
CACGTTCATGC -> ACGTTCATGCA
CACGTTTTTCG -> ACGTTTTTCGT
CACTAATCCAT -> ACTAATCCATT
CACTACTATCT -> ACTACTATCTT
CACTCTAAGTC -> ACTCTAAGTCA
CACTGCTGGCT -> ACTGCTGGCTC
CACTGGACGAC -> ACTGGACGACA
CACTTAGCAGG -> ACTTAGCAGGT
CACTTAGCGAC -> ACTTAGCGACA
CACTTCAGGGC -> ACTTCAGGGCG
CACTTCCCCGA -> ACTTCCCCGAC
CACTTTCGCGT -> ACTTTCGCGTG
CAGACGCGCTC -> AGACGCGCTCG
CAGAGAGAACA -> AGAGAGAACAT
CAGAGTCCTGA -> AGAGTCCTGAC
CAGATGTTCCA -> AGATGTTCCAA
CAGATTTCTCG -> AGATTTCTCGC
CAGCAGGGTTG -> AGCAGGGTTGA
CAGCAGTAGAG -> AGCAGTAGAGA
CAGCATCGACC -> AGCATCGACCA
CAGCATTGTAT -> AGCATTGTATC
CAGCCGAAAAT -> AGCCGAAAATC
CAGCGGAGGCA -> AGCGGAGGCAC
CAGCGGGGTGC -> AGCGGGGTGCA
CAGCTTCTGCT -> AGCTTCTGCTA
CAGCTTGGTTA -> AGCTTGGTTAT
CAGGAAGGATA -> AGGAAGGATAT
CAGGCCTCTAG -> AGGCCTCTAGA
CAGGCTGGGCA -> AGGCTGGGCAA
CAGGGAAAAAC -> AGGGAAAAACC
CAGGGAATCTG -> AGGGAATCTGC
CAGGGCGAAAC -> AGGGCGAAACC
CAGGGTTGAAG -> AGGGTTGAAGT
CAGGTACCCCT -> AGGTACCCCTT
CAGGTCGAGAT -> AGGTCGAGATG
CAGTAGAGACA -> AGTAGAGACAT
CAGTCGAGCCC -> AGTCGAGCCCA
CAGTCGCTTGA -> AGTCGCTTGAG
CAGTCGTGTAA -> AGTCGTGTAAC
CAGTGACGGTG -> AGTGACGGTGT
CAGTGAGGTGT -> AGTGAGGTGTC
CAGTGATACCT -> AGTGATACCTT
CAGTGCTCGGC -> AGTGCTCGGCG
CAGTGGAAAGA -> AGTGGAAAGAC
CAGTGGCCGGT -> AGTGGCCGGTA
CAGTTGGCCAA -> AGTTGGCCAAA
CAGTTTCCTAT -> AGTTTCCTATT
CATAATGATAA -> ATAATGATAAC
CATACGTAACT -> ATACGTAACTA
CATAGACTTCG -> ATAGACTTCGG
CATAGCAACGC -> ATAGCAACGCC
CATATGTGTGC -> ATATGTGTGCC
CATCACCCTCA -> ATCACCCTCAG
CATCACGTTTT -> ATCACGTTTTT
CATCAGGGAAA -> ATCAGGGAAAA
CATCCCCGGGA -> ATCCCCGGGAG
CATCCCGGTGG -> ATCCCGGTGGG
CATCGACCACG -> ATCGACCACGC
CATCTAGAACG -> ATCTAGAACGT
CATCTTGGTTA -> ATCTTGGTTAA
CATGACGTAGA -> ATGACGTAGAG
CATGACTGAAT -> ATGACTGAATT
CATGCAATCTC -> ATGCAATCTCG
CATGGCTCTAC -> ATGGCTCTACG
CATGTGGCCTG -> ATGTGGCCTGC
CATGTTATGAG -> ATGTTATGAGT
CATTACAGATG -> ATTACAGATGT
CATTAGTACAC -> ATTAGTACACC
CATTAGTATAG -> ATTAGTATAGA
CATTATTGTCA -> ATTATTGTCAC
CATTCAAAGAG -> ATTCAAAGAGG
CATTGACTGGT -> ATTGACTGGTG
CATTGGGCCCA -> ATTGGGCCCAC
CATTGTATCGG -> ATTGTATCGGG
CCAAAATTGCC -> CAAAATTGCCG
CCAAACAGGTC -> CAAACAGGTCG
CCAACCCCAAC -> CAACCCCAACG
CCAACCGACAT -> CAACCGACATG
CCAACGGCACC -> CAACGGCACCC
CCAACGTATAG -> CAACGTATAGG
CCAAGCCTCAC -> CAAGCCTCACG
CCACAAGATAA -> CACAAGATAAA
CCACAGTGATA -> CACAGTGATAC
CCACAGTTTCC -> CACAGTTTCCT
CCACATTGACT -> CACATTGACTG
CCACGCTCGTG -> CACGCTCGTGC
CCACTACTATC -> CACTACTATCT
CCACTCTAAGT -> CACTCTAAGTC
CCACTGCTGGC -> CACTGCTGGCT
CCACTTCAGGG -> CACTTCAGGGC
CCACTTCCCCG -> CACTTCCCCGA
CCAGACGCGCT -> CAGACGCGCTC
CCAGAGAGAAC -> CAGAGAGAACA
CCAGCCGAAAA -> CAGCCGAAAAT
CCAGCGGAGGC -> CAGCGGAGGCA
CCAGCTTGGTT -> CAGCTTGGTTA
CCAGGCTGGGC -> CAGGCTGGGCA
CCAGGGAATCT -> CAGGGAATCTG
CCAGTCGTGTA -> CAGTCGTGTAA
CCAGTGCTCGG -> CAGTGCTCGGC
CCAGTGGCCGG -> CAGTGGCCGGT
CCAGTTGGCCA -> CAGTTGGCCAA
CCATCACGTTT -> CATCACGTTTT
CCATTAGTATA -> CATTAGTATAG
CCATTATTGTC -> CATTATTGTCA
CCCAACGTATA -> CCAACGTATAG
CCCACAGTGAT -> CCACAGTGATA
CCCACTACTAT -> CCACTACTATC
CCCAGACGCGC -> CCAGACGCGCT
CCCAGAGAGAA -> CCAGAGAGAAC
CCCAGCGGAGG -> CCAGCGGAGGC
CCCAGGCTGGG -> CCAGGCTGGGC
CCCATCACGTT -> CCATCACGTTT
CCCATTATTGT -> CCATTATTGTC
CCCCAACGTAT -> CCCAACGTATA
CCCCGACCCTA -> CCCGACCCTAT
CCCCGGGAGAC -> CCCGGGAGACG
CCCCTCTGCAC -> CCCTCTGCACG
CCCCTCTGTTT -> CCCTCTGTTTC
CCCCTTGCCGG -> CCCTTGCCGGC
CCCGACCCTAT -> CCGACCCTATT
CCCGACCTCCT -> CCGACCTCCTT
CCCGCGCTATA -> CCGCGCTATAT
CCCGGGAGACG -> CCGGGAGACGT
CCCGGGTCTAG -> CCGGGTCTAGG
CCCGGTGGGTA -> CCGGTGGGTAG
CCCGTAAAAAT -> CCGTAAAAATC
CCCGTACTCAA -> CCGTACTCAAA
CCCTAAGCACC -> CCTAAGCACCT
CCCTATTTACA -> CCTATTTACAG
CCCTCAGATTT -> CCTCAGATTTC
CCCTCTGCACG -> CCTCTGCACGG
CCCTCTGTTTC -> CCTCTGTTTCG
CCCTGCTAACG -> CCTGCTAACGC
CCCTGGCCTGA -> CCTGGCCTGAT
CCCTGGGGGTC -> CCTGGGGGTCA
CCCTTAGTAGA -> CCTTAGTAGAG
CCCTTGCCGGC -> CCTTGCCGGCA
CCGAAAATCTT -> CGAAAATCTTC
CCGAATCTTCT -> CGAATCTTCTT
CCGACATGTTA -> CGACATGTTAT
CCGACCCTATT -> CGACCCTATTT
CCGACCTCCTT -> CGACCTCCTTT
CCGACGTACGC -> CGACGTACGCT
CCGATAGCCTG -> CGATAGCCTGT
CCGATTAAGAA -> CGATTAAGAAA
CCGATTGAGAA -> CGATTGAGAAG
CCGCACAACGC -> CGCACAACGCG
CCGCGAGCGTC -> CGCGAGCGTCT
CCGCGATTCAT -> CGCGATTCATG
CCGCGCTATAT -> CGCGCTATATG
CCGCTCGGGCT -> CGCTCGGGCTT
CCGGATAGTAC -> CGGATAGTACT
CCGGCAAAGCA -> CGGCAAAGCAC
CCGGCGGTATC -> CGGCGGTATCG
CCGGGAGACGT -> CGGGAGACGTA
CCGGGGGGTAT -> CGGGGGGTATG
CCGGGTCTAGG -> CGGGTCTAGGA
CCGGTACTGTT -> CGGTACTGTTT
CCGGTGGGTAG -> CGGTGGGTAGA
CCGGTTGCCGC -> CGGTTGCCGCT
CCGTAAAAATC -> CGTAAAAATCA
CCGTACTCAAA -> CGTACTCAAAG
CCGTAGAGTCA -> CGTAGAGTCAA
CCGTCAAACCA -> CGTCAAACCAC
CCGTCCGATAG -> CGTCCGATAGC
CCGTGACCCTG -> CGTGACCCTGG
CCGTGCGGCGG -> CGTGCGGCGGT
CCGTTTCTTTT -> CGTTTCTTTTT
CCTAAGCACCT -> CTAAGCACCTG
CCTATTGATCA -> CTATTGATCAC
CCTATTTACAG -> CTATTTACAGC
CCTCACGAACA -> CTCACGAACAT
CCTCAGATTTC -> CTCAGATTTCT
CCTCATTCAAA -> CTCATTCAAAG
CCTCCTTTAGA -> CTCCTTTAGAC
CCTCGTGAGTT -> CTCGTGAGTTG
CCTCTAGAGCC -> CTCTAGAGCCA
CCTCTATTCCA -> CTCTATTCCAC
CCTCTGCACGG -> CTCTGCACGGT
CCTCTGTTTCG -> CTCTGTTTCGT
CCTCTTACCAG -> CTCTTACCAGG
CCTCTTCGCAC -> CTCTTCGCACC
CCTGACTGTTG -> CTGACTGTTGA
CCTGAGCCCGA -> CTGAGCCCGAC
CCTGATAGGCG -> CTGATAGGCGC
CCTGATATGCG -> CTGATATGCGG
CCTGCGTTGAC -> CTGCGTTGACA
CCTGCTAACGC -> CTGCTAACGCG
CCTGGCCTGAT -> CTGGCCTGATA
CCTGGGGGTCA -> CTGGGGGTCAG
CCTGTCCCGCG -> CTGTCCCGCGC
CCTGTCCTTAG -> CTGTCCTTAGC
CCTGTGAATAT -> CTGTGAATATC
CCTTAACTGAA -> CTTAACTGAAA
CCTTAGAGCGA -> CTTAGAGCGAC
CCTTAGCACGC -> CTTAGCACGCC
CCTTAGTAGAG -> CTTAGTAGAGA
CCTTCCTCTTA -> CTTCCTCTTAC
CCTTGCCGGCA -> CTTGCCGGCAA
CCTTGTGTATC -> CTTGTGTATCT
CCTTTAGACCC -> CTTTAGACCCT
CGAAAATCTTC -> GAAAATCTTCG
CGAAACCTCTT -> GAAACCTCTTC
CGAACATAATG -> GAACATAATGA
CGAAGAGGGAA -> GAAGAGGGAAC
CGAATCTTCTT -> GAATCTTCTTT
CGACACTTAGC -> GACACTTAGCA
CGACAGGAAGG -> GACAGGAAGGA
CGACATATGTG -> GACATATGTGT
CGACATCACCC -> GACATCACCCT
CGACATCTAGA -> GACATCTAGAA
CGACATGTTAT -> GACATGTTATG
CGACCAACCGA -> GACCAACCGAC
CGACCACATTG -> GACCACATTGA
CGACCACGCTC -> GACCACGCTCG
CGACCAGTGCT -> GACCAGTGCTC
CGACCCTATTT -> GACCCTATTTA
CGACCTCCTTT -> GACCTCCTTTA
CGACGTACGCT -> GACGTACGCTT
CGACTACCGTA -> GACTACCGTAG
CGACTCTAAGA -> GACTCTAAGAT
CGACTTGGTCC -> GACTTGGTCCG
CGAGATGATGA -> GAGATGATGAA
CGAGCATGGCT -> GAGCATGGCTC
CGAGCATGTGG -> GAGCATGTGGC
CGAGCCCAGAC -> GAGCCCAGACG
CGAGCCTGTCC -> GAGCCTGTCCC
CGAGCGTCTTG -> GAGCGTCTTGG
CGAGCTACAGC -> GAGCTACAGCA
CGAGCTCTTCA -> GAGCTCTTCAG
CGAGGCGCCTG -> GAGGCGCCTGA
CGAGTGTGAGA -> GAGTGTGAGAT
CGAGTTGTCTC -> GAGTTGTCTCC
CGATAGCCTGT -> GATAGCCTGTC
CGATATCCGTC -> GATATCCGTCC
CGATCTACTTG -> GATCTACTTGG
CGATGTTGCGA -> GATGTTGCGAC
CGATTAAGAAA -> GATTAAGAAAT
CGATTCATGAC -> GATTCATGACT
CGATTGAGAAG -> GATTGAGAAGA
CGCAATCTCGA -> GCAATCTCGAG
CGCACAACGCG -> GCACAACGCGA
CGCACCAAACA -> GCACCAAACAG
CGCACCAAGCC -> GCACCAAGCCT
CGCAGGCCTCT -> GCAGGCCTCTA
CGCATAGCAAC -> GCATAGCAACG
CGCATTACAGA -> GCATTACAGAT
CGCCACTTCAG -> GCCACTTCAGG
CGCCCACAGTG -> GCCCACAGTGA
CGCCCCTCTGC -> GCCCCTCTGCA
CGCCGCACAAC -> GCCGCACAACG
CGCCTGATAGG -> GCCTGATAGGC
CGCGAAGAGGG -> GCGAAGAGGGA
CGCGACACTTA -> GCGACACTTAG
CGCGAGCGTCT -> GCGAGCGTCTT
CGCGAGCTCTT -> GCGAGCTCTTC
CGCGAGTGTGA -> GCGAGTGTGAG
CGCGATTCATG -> GCGATTCATGA
CGCGCTATATG -> GCGCTATATGT
CGCGCTCGAGG -> GCGCTCGAGGC
CGCGTGAGCTC -> GCGTGAGCTCC
CGCGTTAATAC -> GCGTTAATACT
CGCTATATGTA -> GCTATATGTAG
CGCTCAAGTAG -> GCTCAAGTAGG
CGCTCGAGGCG -> GCTCGAGGCGC
CGCTCGGGCTT -> GCTCGGGCTTC
CGCTCGTGCCT -> GCTCGTGCCTT
CGCTTCAAAGC -> GCTTCAAAGCA
CGCTTGAGATA -> GCTTGAGATAA
CGGAAGGTGTG -> GGAAGGTGTGA
CGGACGACATC -> GGACGACATCA
CGGACGAGCTA -> GGACGAGCTAC
CGGAGGCACCG -> GGAGGCACCGT
CGGATAGTACT -> GGATAGTACTG
CGGCAAAGCAC -> GGCAAAGCACT
CGGCACCCATT -> GGCACCCATTA
CGGCCTGAGCC -> GGCCTGAGCCC
CGGCGAGCATG -> GGCGAGCATGT
CGGCGGTATCG -> GGCGGTATCGT
CGGCGGTTGGT -> GGCGGTTGGTT
CGGGAACGATA -> GGGAACGATAT
CGGGAGACGTA -> GGGAGACGTAC
CGGGATTGAGT -> GGGATTGAGTT
CGGGCCGCGAT -> GGGCCGCGATT
CGGGCTTCTGC -> GGGCTTCTGCG
CGGGGGGGCGA -> GGGGGGGCGAG
CGGGGGGTATG -> GGGGGGTATGG
CGGGGTGCAAC -> GGGGTGCAACA
CGGGTCTAGGA -> GGGTCTAGGAG
CGGGTTGTCCG -> GGGTTGTCCGG
CGGTACTGTTT -> GGTACTGTTTC
CGGTATCGTCC -> GGTATCGTCCG
CGGTGCGATGT -> GGTGCGATGTT
CGGTGGGTAGA -> GGTGGGTAGAA
CGGTGTATAGG -> GGTGTATAGGC
CGGTTGCCGCT -> GGTTGCCGCTC
CGGTTGGATTA -> GGTTGGATTAA
CGGTTGGTTTC -> GGTTGGTTTCC
CGGTTTTCCAG -> GGTTTTCCAGT
CGTAAAAATCA -> GTAAAAATCAC
CGTAACTAATG -> GTAACTAATGG
CGTAATCCCAT -> GTAATCCCATC
CGTAATTTGGC -> GTAATTTGGCA
CGTACCAGTGG -> GTACCAGTGGC
CGTACGCTTCA -> GTACGCTTCAA
CGTACTCAAAG -> GTACTCAAAGG
CGTAGAGGGGT -> GTAGAGGGGTA
CGTAGAGTCAA -> GTAGAGTCAAA
CGTATAAAAAT -> GTATAAAAATG
CGTATAGGGCA -> GTATAGGGCAG
CGTCAAACCAC -> GTCAAACCACT
CGTCCGATAGC -> GTCCGATAGCC
CGTCCGCGAGC -> GTCCGCGAGCG
CGTCCGTTTCT -> GTCCGTTTCTT
CGTCGCCCACA -> GTCGCCCACAG
CGTCTTGGGAG -> GTCTTGGGAGC
CGTGACCCGGG -> GTGACCCGGGT
CGTGACCCTGG -> GTGACCCTGGC
CGTGAGCTCCC -> GTGAGCTCCCA
CGTGAGTTGTT -> GTGAGTTGTTT
CGTGCCTTCCT -> GTGCCTTCCTC
CGTGCGGCGGT -> GTGCGGCGGTT
CGTGCGGGAAC -> GTGCGGGAACG
CGTGTAACCCC -> GTGTAACCCCT
CGTTAATACTA -> GTTAATACTAT
CGTTATCACGC -> GTTATCACGCT
CGTTCATGCAA -> GTTCATGCAAT
CGTTGACAAGT -> GTTGACAAGTG
CGTTTCACGCA -> GTTTCACGCAG
CGTTTCTTTTT -> GTTTCTTTTTG
CGTTTTTCGTA -> GTTTTTCGTAA
CTAAACACTTA -> TAAACACTTAG
CTAAATGCGAC -> TAAATGCGACT
CTAACGCGACA -> TAACGCGACAC
CTAAGATAAGG -> TAAGATAAGGA
CTAAGCACCTG -> TAAGCACCTGT
CTAAGTCAGTC -> TAAGTCAGTCG
CTAATCCATTA -> TAATCCATTAG
CTAATGGCAAG -> TAATGGCAAGG
CTACAGCATCG -> TACAGCATCGA
CTACCGTAGAG -> TACCGTAGAGT
CTACCGTGCGG -> TACCGTGCGGC
CTACGACCACA -> TACGACCACAT
CTACTACCGTG -> TACTACCGTGC
CTACTATCTTC -> TACTATCTTCA
CTACTTGGGCA -> TACTTGGGCAA
CTAGAACGTAT -> TAGAACGTATA
CTAGAGCCAAC -> TAGAGCCAACC
CTAGAGTTCCG -> TAGAGTTCCGA
CTAGGAGTAAA -> TAGGAGTAAAG
CTATACAAATC -> TATACAAATCT
CTATATGTAGA -> TATATGTAGAT
CTATCGCGTTA -> TATCGCGTTAA
CTATCTAAATG -> TATCTAAATGC
CTATCTTCATG -> TATCTTCATGA
CTATTCCACTG -> TATTCCACTGC
CTATTGATCAC -> TATTGATCACT
CTATTTACAGC -> TATTTACAGCG
CTCAAAGGCGC -> TCAAAGGCGCC
CTCAAGTAGGC -> TCAAGTAGGCC
CTCACGAACAT -> TCACGAACATA
CTCAGATTTCT -> TCAGATTTCTC
CTCATTCAAAG -> TCATTCAAAGA
CTCCCAGCGGA -> TCCCAGCGGAG
CTCCTCATTCA -> TCCTCATTCAA
CTCCTTTAGAC -> TCCTTTAGACC
CTCGAGCATGG -> TCGAGCATGGC
CTCGAGGCGCC -> TCGAGGCGCCT
CTCGAGTTGTC -> TCGAGTTGTCT
CTCGCAATCTC -> TCGCAATCTCG
CTCGCATAGCA -> TCGCATAGCAA
CTCGGCGAGCA -> TCGGCGAGCAT
CTCGGGCCGCG -> TCGGGCCGCGA
CTCGGGCTTCT -> TCGGGCTTCTG
CTCGTGAGTTG -> TCGTGAGTTGT
CTCGTGCCTTC -> TCGTGCCTTCC
CTCTAAGATAA -> TCTAAGATAAG
CTCTAAGTCAG -> TCTAAGTCAGT
CTCTACGACCA -> TCTACGACCAC
CTCTACTACCG -> TCTACTACCGT
CTCTAGAGCCA -> TCTAGAGCCAA
CTCTATTCCAC -> TCTATTCCACT
CTCTCGCAATC -> TCTCGCAATCT
CTCTGCACGGT -> TCTGCACGGTT
CTCTGTTTCGT -> TCTGTTTCGTT
CTCTTACCAGG -> TCTTACCAGGG
CTCTTCAGTGA -> TCTTCAGTGAC
CTCTTCGCACC -> TCTTCGCACCA
CTGAAAGGCGT -> TGAAAGGCGTC
CTGAAATGACG -> TGAAATGACGG
CTGAATTCGTC -> TGAATTCGTCG
CTGACTGTTGA -> TGACTGTTGAC
CTGAGCCCGAC -> TGAGCCCGACC
CTGATAGGCGC -> TGATAGGCGCA
CTGATATGCGG -> TGATATGCGGT
CTGCACGGTTT -> TGCACGGTTTT
CTGCCTCGTGA -> TGCCTCGTGAG
CTGCGGAAGGT -> TGCGGAAGGTG
CTGCGTTGACA -> TGCGTTGACAA
CTGCTAACGCG -> TGCTAACGCGA
CTGCTAGAGTT -> TGCTAGAGTTC
CTGCTGGCTCT -> TGCTGGCTCTC
CTGGACGACAT -> TGGACGACATA
CTGGCCTGATA -> TGGCCTGATAT
CTGGCTCTCGC -> TGGCTCTCGCA
CTGGGCAATTC -> TGGGCAATTCG
CTGGGGGTCAG -> TGGGGGTCAGC
CTGGTGCGTTA -> TGGTGCGTTAT
CTGTCCCGCGC -> TGTCCCGCGCT
CTGTCCTTAGC -> TGTCCTTAGCA
CTGTGAATATC -> TGTGAATATCG
CTGTTGACGAC -> TGTTGACGACT
CTGTTGTACAC -> TGTTGTACACC
CTGTTTCATCA -> TGTTTCATCAG
CTGTTTCGTTT -> TGTTTCGTTTC
CTTAACTGAAA -> TTAACTGAAAT
CTTACCAGGGA -> TTACCAGGGAA
CTTAGAGCGAC -> TTAGAGCGACT
CTTAGCACGCC -> TTAGCACGCCG
CTTAGCAGGTA -> TTAGCAGGTAC
CTTAGCGACAG -> TTAGCGACAGG
CTTAGTAGAGA -> TTAGTAGAGAA
CTTAGTCAGAG -> TTAGTCAGAGT
CTTCAAAGCAT -> TTCAAAGCATC
CTTCAGGGCGA -> TTCAGGGCGAA
CTTCAGTGACG -> TTCAGTGACGG
CTTCATGACGT -> TTCATGACGTA
CTTCCCCGACC -> TTCCCCGACCC
CTTCCTCTTAC -> TTCCTCTTACC
CTTCGCACCAA -> TTCGCACCAAA
CTTCGCATTAC -> TTCGCATTACA
CTTCGGACGAG -> TTCGGACGAGC
CTTCTGCGGAA -> TTCTGCGGAAG
CTTCTGCTAGA -> TTCTGCTAGAG
CTTCTTTCCAG -> TTCTTTCCAGC
CTTGAGATAAA -> TTGAGATAAAG
CTTGCCGGCAA -> TTGCCGGCAAA
CTTGGGAGCAT -> TTGGGAGCATA
CTTGGGCAATT -> TTGGGCAATTC
CTTGGTCCGGT -> TTGGTCCGGTT
CTTGGTTAAAG -> TTGGTTAAAGG
CTTGGTTATGT -> TTGGTTATGTC
CTTGTGTATCT -> TTGTGTATCTC
CTTTAGACCCT -> TTTAGACCCTA
CTTTCCAGCTT -> TTTCCAGCTTG
CTTTCGCGTGA -> TTTCGCGTGAG
CTTTTTGGCGG -> TTTTTGGCGGT
GAAAAACCGGC -> AAAAACCGGCG
GAAAATCTTCG -> AAAATCTTCGC
GAAACACCGAC -> AAACACCGACG
GAAACCTCTTC -> AAACCTCTTCG
GAAAGACAGCA -> AAAGACAGCAG
GAAAGGCGTCC -> AAAGGCGTCCG
GAAATGACGGG -> AAATGACGGGG
GAAATGGGCCC -> AAATGGGCCCT
GAACATAATGA -> AACATAATGAT
GAACATTGGGC -> AACATTGGGCC
GAACCTCTATT -> AACCTCTATTC
GAACGATATCC -> AACGATATCCG
GAACGTATAAA -> AACGTATAAAA
GAAGAGGGAAC -> AAGAGGGAACC
GAAGATGACCA -> AAGATGACCAG
GAAGGATATTT -> AAGGATATTTT
GAAGGTGCTAT -> AAGGTGCTATA
GAAGGTGTGAG -> AAGGTGTGAGG
GAAGTAGCATT -> AAGTAGCATTA
GAAGTCCCGTA -> AAGTCCCGTAC
GAATATCGGGT -> AATATCGGGTT
GAATCTGCCTC -> AATCTGCCTCG
GAATCTTCTTT -> AATCTTCTTTC
GAATTACCCTT -> AATTACCCTTA
GAATTCGTCGC -> AATTCGTCGCC
GACAAGTGTCA -> ACAAGTGTCAG
GACACGTGACC -> ACACGTGACCC
GACACTTAGCA -> ACACTTAGCAG
GACAGCAGTAG -> ACAGCAGTAGA
GACAGGAAGGA -> ACAGGAAGGAT
GACATATGTGT -> ACATATGTGTG
GACATCACCCT -> ACATCACCCTC
GACATCCCCGG -> ACATCCCCGGG
GACATCTAGAA -> ACATCTAGAAC
GACATGTTATG -> ACATGTTATGA
GACCAACCGAC -> ACCAACCGACA
GACCACATTGA -> ACCACATTGAC
GACCACGCTCG -> ACCACGCTCGT
GACCAGCCGAA -> ACCAGCCGAAA
GACCAGTGCTC -> ACCAGTGCTCG
GACCCGGGTCT -> ACCCGGGTCTA
GACCCTAAGCA -> ACCCTAAGCAC
GACCCTATTTA -> ACCCTATTTAC
GACCCTGGCCT -> ACCCTGGCCTG
GACCTCCTTTA -> ACCTCCTTTAG
GACGACATATG -> ACGACATATGT
GACGACATCAC -> ACGACATCACC
GACGACTCTAA -> ACGACTCTAAG
GACGAGCTACA -> ACGAGCTACAG
GACGCGCTCGA -> ACGCGCTCGAG
GACGGGGGGGC -> ACGGGGGGGCG
GACGGTGTATA -> ACGGTGTATAG
GACGTACCAGT -> ACGTACCAGTG
GACGTACGCTT -> ACGTACGCTTC
GACGTAGAGGG -> ACGTAGAGGGG
GACTACCGTAG -> ACTACCGTAGA
GACTCTAAGAT -> ACTCTAAGATA
GACTGAATTCG -> ACTGAATTCGT
GACTGGTGCGT -> ACTGGTGCGTT
GACTGTTGACG -> ACTGTTGACGA
GACTTCGGACG -> ACTTCGGACGA
GACTTGGTCCG -> ACTTGGTCCGG
GAGAAACACCG -> AGAAACACCGA
GAGAACATTGG -> AGAACATTGGG
GAGAAGATGAC -> AGAAGATGACC
GAGAAGGTGCT -> AGAAGGTGCTA
GAGACATCCCC -> AGACATCCCCG
GAGACGTACCA -> AGACGTACCAG
GAGAGAACATT -> AGAGAACATTG
GAGATAAAGTT -> AGATAAAGTTG
GAGATGAGAAA -> AGATGAGAAAC
GAGATGATGAA -> AGATGATGAAG
GAGATTGGTAG -> AGATTGGTAGG
GAGCATACGTA -> AGCATACGTAA
GAGCATGGCTC -> AGCATGGCTCT
GAGCATGTGGC -> AGCATGTGGCC
GAGCCAACCCC -> AGCCAACCCCA
GAGCCCAGACG -> AGCCCAGACGC
GAGCCCGACCT -> AGCCCGACCTC
GAGCCTGTCCC -> AGCCTGTCCCG
GAGCGACTTGG -> AGCGACTTGGT
GAGCGTCTTGG -> AGCGTCTTGGG
GAGCTACAGCA -> AGCTACAGCAT
GAGCTCCCAGC -> AGCTCCCAGCG
GAGCTCTTCAG -> AGCTCTTCAGT
GAGGCACCGTC -> AGGCACCGTCA
GAGGCAGCTTC -> AGGCAGCTTCT
GAGGCGCCTGA -> AGGCGCCTGAT
GAGGGAACCTC -> AGGGAACCTCT
GAGGGGTACCT -> AGGGGTACCTT
GAGGGTGGGAG -> AGGGTGGGAGA
GAGGGTTACTC -> AGGGTTACTCT
GAGGTGTCACG -> AGGTGTCACGG
GAGGTTCGTGC -> AGGTTCGTGCG
GAGTAAAGCGA -> AGTAAAGCGAC
GAGTCAAAGCG -> AGTCAAAGCGT
GAGTCCTGACT -> AGTCCTGACTG
GAGTGTGAGAT -> AGTGTGAGATT
GAGTTAGGGTA -> AGTTAGGGTAC
GAGTTCATCTT -> AGTTCATCTTG
GAGTTCCGATT -> AGTTCCGATTA
GAGTTGCGCGA -> AGTTGCGCGAG
GAGTTGTCTCC -> AGTTGTCTCCT
GAGTTGTTTCA -> AGTTGTTTCAA
GATAAAGTGCT -> ATAAAGTGCTA
GATAAAGTTGC -> ATAAAGTTGCG
GATAACCACTT -> ATAACCACTTC
GATAAGGATTA -> ATAAGGATTAT
GATACCTTAAC -> ATACCTTAACT
GATAGCCTGTC -> ATAGCCTGTCC
GATAGGCGCAC -> ATAGGCGCACT
GATAGTACTGA -> ATAGTACTGAA
GATATCCGTCC -> ATATCCGTCCG
GATATCGGACG -> ATATCGGACGA
GATATGCGGTG -> ATATGCGGTGC
GATATTTTCAG -> ATATTTTCAGT
GATCACTAATC -> ATCACTAATCC
GATCTACTTGG -> ATCTACTTGGG
GATGAAGTCCC -> ATGAAGTCCCG
GATGACACGTG -> ATGACACGTGA
GATGACCAGCC -> ATGACCAGCCG
GATGAGAAACA -> ATGAGAAACAC
GATGATGAAGT -> ATGATGAAGTC
GATGGGTTAGT -> ATGGGTTAGTC
GATGTTCCAAC -> ATGTTCCAACG
GATGTTGCGAC -> ATGTTGCGACC
GATTAACGATC -> ATTAACGATCT
GATTAAGAAAT -> ATTAAGAAATG
GATTATGGATT -> ATTATGGATTG
GATTCATGACT -> ATTCATGACTG
GATTGAGAAGA -> ATTGAGAAGAT
GATTGAGTTGC -> ATTGAGTTGCG
GATTGGTAGGC -> ATTGGTAGGCC
GATTGTTTCCG -> ATTGTTTCCGT
GATTTCTCGCA -> ATTTCTCGCAT
GCAAAGCACTT -> CAAAGCACTTT
GCAACAATGCT -> CAACAATGCTT
GCAACGCCACT -> CAACGCCACTT
GCAAGGAGTTA -> CAAGGAGTTAG
GCAATCTCGAG -> CAATCTCGAGC,CAATCTCGAGT
GCAATTCACAG -> CAATTCACAGT
GCAATTCGACC -> CAATTCGACCA
GCACAACGCGA -> CACAACGCGAG
GCACCAAACAG -> CACCAAACAGG
GCACCAAGCCT -> CACCAAGCCTC
GCACCCATTAT -> CACCCATTATT
GCACCGTCAAA -> CACCGTCAAAC
GCACCTGTGAA -> CACCTGTGAAT
GCACGCCGCAC -> CACGCCGCACA
GCACGGTTTTC -> CACGGTTTTCC
GCACGTTCATG -> CACGTTCATGC
GCACTTTCGCG -> CACTTTCGCGT
GCAGCAGGGTT -> CAGCAGGGTTG
GCAGCTTCTGC -> CAGCTTCTGCT
GCAGGCCTCTA -> CAGGCCTCTAG
GCAGGGTTGAA -> CAGGGTTGAAG
GCAGGTACCCC -> CAGGTACCCCT
GCAGTAGAGAC -> CAGTAGAGACA
GCATACGTAAC -> CATACGTAACT
GCATAGACTTC -> CATAGACTTCG
GCATAGCAACG -> CATAGCAACGC
GCATCCCGGTG -> CATCCCGGTGG
GCATCGACCAC -> CATCGACCACG
GCATGGCTCTA -> CATGGCTCTAC
GCATGTGGCCT -> CATGTGGCCTG
GCATTACAGAT -> CATTACAGATG
GCATTAGTACA -> CATTAGTACAC
GCATTGTATCG -> CATTGTATCGG
GCCAAAATTGC -> CCAAAATTGCC
GCCAACCCCAA -> CCAACCCCAAC
GCCACAGTTTC -> CCACAGTTTCC
GCCACTTCAGG -> CCACTTCAGGG
GCCCACAGTGA -> CCCACAGTGAT
GCCCACTACTA -> CCCACTACTAT
GCCCAGACGCG -> CCCAGACGCGC
GCCCCTCTGCA -> CCCCTCTGCAC
GCCCGACCTCC -> CCCGACCTCCT
GCCCTGCTAAC -> CCCTGCTAACG
GCCCTGGGGGT -> CCCTGGGGGTC
GCCGAAAATCT -> CCGAAAATCTT
GCCGAATCTTC -> CCGAATCTTCT
GCCGATTGAGA -> CCGATTGAGAA
GCCGCACAACG -> CCGCACAACGC
GCCGCGATTCA -> CCGCGATTCAT
GCCGCTCGGGC -> CCGCTCGGGCT
GCCGGCAAAGC -> CCGGCAAAGCA
GCCGGTACTGT -> CCGGTACTGTT
GCCTCACGAAC -> CCTCACGAACA
GCCTCGTGAGT -> CCTCGTGAGTT
GCCTCTAGAGC -> CCTCTAGAGCC
GCCTGAGCCCG -> CCTGAGCCCGA
GCCTGATAGGC -> CCTGATAGGCG
GCCTGATATGC -> CCTGATATGCG
GCCTGCGTTGA -> CCTGCGTTGAC
GCCTGTCCCGC -> CCTGTCCCGCG
GCCTGTCCTTA -> CCTGTCCTTAG
GCCTTCCTCTT -> CCTTCCTCTTA
GCCTTGTGTAT -> CCTTGTGTATC
GCGAAACCTCT -> CGAAACCTCTT
GCGAAGAGGGA -> CGAAGAGGGAA
GCGACACTTAG -> CGACACTTAGC
GCGACAGGAAG -> CGACAGGAAGG
GCGACATCTAG -> CGACATCTAGA
GCGACCAACCG -> CGACCAACCGA
GCGACTACCGT -> CGACTACCGTA
GCGACTTGGTC -> CGACTTGGTCC
GCGAGCATGTG -> CGAGCATGTGG
GCGAGCCTGTC -> CGAGCCTGTCC
GCGAGCGTCTT -> CGAGCGTCTTG
GCGAGCTCTTC -> CGAGCTCTTCA
GCGAGTGTGAG -> CGAGTGTGAGA
GCGATGTTGCG -> CGATGTTGCGA
GCGATTCATGA -> CGATTCATGAC
GCGCCCCTCTG -> CGCCCCTCTGC
GCGCCTGATAG -> CGCCTGATAGG
GCGCGAAGAGG -> CGCGAAGAGGG
GCGCGAGCTCT -> CGCGAGCTCTT
GCGCTATATGT -> CGCTATATGTA
GCGCTCGAGGC -> CGCTCGAGGCG
GCGGAAGGTGT -> CGGAAGGTGTG
GCGGAGGCACC -> CGGAGGCACCG
GCGGCGGTTGG -> CGGCGGTTGGT
GCGGGAACGAT -> CGGGAACGATA
GCGGGGTGCAA -> CGGGGTGCAAC
GCGGTATCGTC -> CGGTATCGTCC
GCGGTGCGATG -> CGGTGCGATGT
GCGGTTGGATT -> CGGTTGGATTA
GCGGTTGGTTT -> CGGTTGGTTTC
GCGTAATCCCA -> CGTAATCCCAT
GCGTCCGTTTC -> CGTCCGTTTCT
GCGTCTTGGGA -> CGTCTTGGGAG
GCGTGAGCTCC -> CGTGAGCTCCC
GCGTTAATACT -> CGTTAATACTA
GCGTTATCACG -> CGTTATCACGC
GCGTTGACAAG -> CGTTGACAAGT
GCTAACGCGAC -> CTAACGCGACA
GCTACAGCATC -> CTACAGCATCG
GCTAGAGTTCC -> CTAGAGTTCCG
GCTATACAAAT -> CTATACAAATC
GCTATATGTAG -> CTATATGTAGA
GCTATCGCGTT -> CTATCGCGTTA
GCTCAAGTAGG -> CTCAAGTAGGC
GCTCCCAGCGG -> CTCCCAGCGGA
GCTCGAGGCGC -> CTCGAGGCGCC
GCTCGGCGAGC -> CTCGGCGAGCA
GCTCGGGCTTC -> CTCGGGCTTCT
GCTCGTGCCTT -> CTCGTGCCTTC
GCTCTACGACC -> CTCTACGACCA
GCTCTCGCAAT -> CTCTCGCAATC
GCTCTTCAGTG -> CTCTTCAGTGA
GCTGGCTCTCG -> CTGGCTCTCGC
GCTGGGCAATT -> CTGGGCAATTC
GCTTAGTCAGA -> CTTAGTCAGAG
GCTTCAAAGCA -> CTTCAAAGCAT
GCTTCTGCGGA -> CTTCTGCGGAA
GCTTCTGCTAG -> CTTCTGCTAGA
GCTTGAGATAA -> CTTGAGATAAA
GCTTGGTTATG -> CTTGGTTATGT
GGAAAAACCGG -> GAAAAACCGGC
GGAAAGACAGC -> GAAAGACAGCA
GGAACCTCTAT -> GAACCTCTATT
GGAACGATATC -> GAACGATATCC
GGAAGGATATT -> GAAGGATATTT
GGAAGGTGTGA -> GAAGGTGTGAG
GGAATCTGCCT -> GAATCTGCCTC
GGACGACATAT -> GACGACATATG
GGACGACATCA -> GACGACATCAC
GGACGAGCTAC -> GACGAGCTACA
GGAGACGTACC -> GAGACGTACCA
GGAGATGAGAA -> GAGATGAGAAA
GGAGCATACGT -> GAGCATACGTA
GGAGGCACCGT -> GAGGCACCGTC
GGAGGGTGGGA -> GAGGGTGGGAG
GGAGTAAAGCG -> GAGTAAAGCGA
GGAGTTAGGGT -> GAGTTAGGGTA
GGATAGTACTG -> GATAGTACTGA
GGATATTTTCA -> GATATTTTCAG
GGATTAACGAT -> GATTAACGATC
GGATTATGGAT -> GATTATGGATT
GGATTGAGTTG -> GATTGAGTTGC
GGATTGTTTCC -> GATTGTTTCCG
GGCAAAGCACT -> GCAAAGCACTT
GGCAAGGAGTT -> GCAAGGAGTTA
GGCAATTCACA -> GCAATTCACAG
GGCAATTCGAC -> GCAATTCGACC
GGCACCCATTA -> GCACCCATTAT
GGCACCGTCAA -> GCACCGTCAAA
GGCACGTTCAT -> GCACGTTCATG
GGCAGCAGGGT -> GCAGCAGGGTT
GGCAGCTTCTG -> GCAGCTTCTGC
GGCATAGACTT -> GCATAGACTTC
GGCCAAAATTG -> GCCAAAATTGC
GGCCACAGTTT -> GCCACAGTTTC
GGCCCACTACT -> GCCCACTACTA
GGCCCTGCTAA -> GCCCTGCTAAC
GGCCGATTGAG -> GCCGATTGAGA
GGCCGCGATTC -> GCCGCGATTCA
GGCCGGTACTG -> GCCGGTACTGT
GGCCTCTAGAG -> GCCTCTAGAGC
GGCCTGAGCCC -> GCCTGAGCCCG
GGCCTGATATG -> GCCTGATATGC
GGCCTGCGTTG -> GCCTGCGTTGA
GGCGAAACCTC -> GCGAAACCTCT
GGCGAGCATGT -> GCGAGCATGTG
GGCGAGCCTGT -> GCGAGCCTGTC
GGCGCACTTTA -> GCGCACTTTAT
GGCGCCCCTCT -> GCGCCCCTCTG
GGCGCCTGATA -> GCGCCTGATAG
GGCGGTATCGT -> GCGGTATCGTC
GGCGGTTGGAT -> GCGGTTGGATT
GGCGGTTGGTT -> GCGGTTGGTTT
GGCGTCCGTTT -> GCGTCCGTTTC
GGCTCTACGAC -> GCTCTACGACC
GGCTCTCGCAA -> GCTCTCGCAAT
GGCTGGGCAAT -> GCTGGGCAATT
GGCTTCTGCGG -> GCTTCTGCGGA
GGGAAAAACCG -> GGAAAAACCGG
GGGAACCTCTA -> GGAACCTCTAT
GGGAACGATAT -> GGAACGATATC
GGGAATCTGCC -> GGAATCTGCCT
GGGAGACGTAC -> GGAGACGTACC
GGGAGATGAGA -> GGAGATGAGAA
GGGAGCATACG -> GGAGCATACGT
GGGATTGAGTT -> GGATTGAGTTG
GGGCAATTCAC -> GGCAATTCACA
GGGCAATTCGA -> GGCAATTCGAC
GGGCAGCAGGG -> GGCAGCAGGGT
GGGCCCACTAC -> GGCCCACTACT
GGGCCCTGCTA -> GGCCCTGCTAA
GGGCCGCGATT -> GGCCGCGATTC
GGGCGAAACCT -> GGCGAAACCTC
GGGCGAGCCTG -> GGCGAGCCTGT
GGGCTTCTGCG -> GGCTTCTGCGG
GGGGCGAGCCT -> GGGCGAGCCTG
GGGGGCGAGCC -> GGGGCGAGCCT
GGGGGGCGAGC -> GGGGGCGAGCC
GGGGGGGCGAG -> GGGGGGCGAGC
GGGGGGTATGG -> GGGGGTATGGA
GGGGGTATGGA -> GGGGTATGGAG
GGGGGTCAGCA -> GGGGTCAGCAT
GGGGTACCTTA -> GGGTACCTTAG
GGGGTATGGAG -> GGGTATGGAGG
GGGGTCAGCAT -> GGGTCAGCATT
GGGGTGCAACA -> GGGTGCAACAA
GGGTACACTGG -> GGTACACTGGA
GGGTACCTTAG -> GGTACCTTAGA
GGGTAGAATTA -> GGTAGAATTAC
GGGTATGGAGG -> GGTATGGAGGG
GGGTCAGCATT -> GGTCAGCATTG
GGGTCTAGGAG -> GGTCTAGGAGT
GGGTGCAACAA -> GGTGCAACAAT
GGGTGGGAGAT -> GGTGGGAGATG
GGGTTACTCTA -> GGTTACTCTAC
GGGTTAGTCCC -> GGTTAGTCCCA
GGGTTGAAGTA -> GGTTGAAGTAG
GGGTTGTCCGG -> GGTTGTCCGGG
GGTACACTGGA -> GTACACTGGAC
GGTACCCCTTG -> GTACCCCTTGC
GGTACCTTAGA -> GTACCTTAGAG
GGTACTGTTTC -> GTACTGTTTCA
GGTAGAATTAC -> GTAGAATTACC
GGTAGGCCGAT -> GTAGGCCGATT
GGTATCGTCCG -> GTATCGTCCGC
GGTATGGAGGG -> GTATGGAGGGT
GGTCAGCATTG -> GTCAGCATTGT
GGTCCGGTTGC -> GTCCGGTTGCC
GGTCGAGATGA -> GTCGAGATGAT
GGTCTAGGAGT -> GTCTAGGAGTA
GGTGCAACAAT -> GTGCAACAATG
GGTGCGATGTT -> GTGCGATGTTG
GGTGCGTTATC -> GTGCGTTATCA
GGTGCTATACA -> GTGCTATACAA
GGTGGGAGATG -> GTGGGAGATGA
GGTGGGTAGAA -> GTGGGTAGAAT
GGTGTATAGGC -> GTGTATAGGCA
GGTGTCACGGC -> GTGTCACGGCC
GGTGTGAGGCA -> GTGTGAGGCAG
GGTTAAAGGTT -> GTTAAAGGTTG
GGTTACTCTAC -> GTTACTCTACT
GGTTAGTCCCA -> GTTAGTCCCAG
GGTTATGTCTG -> GTTATGTCTGT
GGTTCGTGCGG -> GTTCGTGCGGG
GGTTGAAGTAG -> GTTGAAGTAGC
GGTTGATGACA -> GTTGATGACAC
GGTTGCCGCTC -> GTTGCCGCTCG
GGTTGGATTAA -> GTTGGATTAAC
GGTTGGTTTCC -> GTTGGTTTCCC
GGTTGTCCGGG -> GTTGTCCGGGG
GGTTTCCCAGG -> GTTTCCCAGGC
GGTTTTCCAGT -> GTTTTCCAGTC
GTAAAAATCAC -> TAAAAATCACC
GTAAAGCGACA -> TAAAGCGACAT
GTAACCCCTCT -> TAACCCCTCTG
GTAACTAATGG -> TAACTAATGGC
GTAATCCCATC -> TAATCCCATCA
GTAATTTGGCA -> TAATTTGGCAC
GTACACCACAA -> TACACCACAAG
GTACACCCGTA -> TACACCCGTAA
GTACACTGGAC -> TACACTGGACG
GTACCAGTGGC -> TACCAGTGGCC
GTACCCCTTGC -> TACCCCTTGCC
GTACCTTAGAG -> TACCTTAGAGC
GTACGCTTCAA -> TACGCTTCAAA
GTACTCAAAGG -> TACTCAAAGGC
GTACTGAAAGG -> TACTGAAAGGC
GTACTGTTTCA -> TACTGTTTCAT
GTAGAATTACC -> TAGAATTACCC
GTAGAGAAGGT -> TAGAGAAGGTG
GTAGAGACATC -> TAGAGACATCC
GTAGAGGGGTA -> TAGAGGGGTAC
GTAGAGTCAAA -> TAGAGTCAAAG
GTAGATGGGTT -> TAGATGGGTTA
GTAGCATTAGT -> TAGCATTAGTA
GTAGGCCACAG -> TAGGCCACAGT
GTAGGCCGATT -> TAGGCCGATTG
GTATAAAAATG -> TATAAAAATGC
GTATAGAGGTT -> TATAGAGGTTC
GTATAGGCATA -> TATAGGCATAG
GTATAGGGCAG -> TATAGGGCAGC
GTATCGGGATT -> TATCGGGATTG
GTATCGTCCGC -> TATCGTCCGCG
GTATCTCGGGC -> TATCTCGGGCC
GTATGGAGGGT -> TATGGAGGGTG
GTCAAACCACT -> TCAAACCACTC
GTCAAAGCGTA -> TCAAAGCGTAA
GTCACGCACCA -> TCACGCACCAA
GTCACGGCCTG -> TCACGGCCTGA
GTCAGAGTCCT -> TCAGAGTCCTG
GTCAGCATTGT -> TCAGCATTGTA
GTCAGTCGAGC -> TCAGTCGAGCC
GTCAGTGAGGT -> TCAGTGAGGTG
GTCCCAGAGAG -> TCCCAGAGAGA
GTCCCGCGCTA -> TCCCGCGCTAT
GTCCCGTACTC -> TCCCGTACTCA
GTCCGATAGCC -> TCCGATAGCCT
GTCCGCGAGCG -> TCCGCGAGCGT
GTCCGGGGGGT -> TCCGGGGGGTA
GTCCGGTTGCC -> TCCGGTTGCCG
GTCCGTTTCTT -> TCCGTTTCTTT
GTCCTGACTGT -> TCCTGACTGTT
GTCCTTAGCAC -> TCCTTAGCACG
GTCGAGATGAT -> TCGAGATGATG
GTCGAGCCCAG -> TCGAGCCCAGA
GTCGCCCACAG -> TCGCCCACAGT
GTCGCTTGAGA -> TCGCTTGAGAT
GTCGTGTAACC -> TCGTGTAACCC
GTCTAGGAGTA -> TCTAGGAGTAA
GTCTCCTCATT -> TCTCCTCATTC
GTCTGTTGTAC -> TCTGTTGTACA
GTCTTGGGAGC -> TCTTGGGAGCA
GTGAATATCGG -> TGAATATCGGG
GTGACCCGGGT -> TGACCCGGGTC
GTGACCCTGGC -> TGACCCTGGCC
GTGACGGTGTA -> TGACGGTGTAT
GTGAGATTGGT -> TGAGATTGGTA
GTGAGCTCCCA -> TGAGCTCCCAG
GTGAGGCAGCT -> TGAGGCAGCTT
GTGAGGTGTCA -> TGAGGTGTCAC
GTGAGTTGTTT -> TGAGTTGTTTC
GTGATACCTTA -> TGATACCTTAA
GTGCAACAATG -> TGCAACAATGC
GTGCCCTGGGG -> TGCCCTGGGGG
GTGCCTTCCTC -> TGCCTTCCTCT
GTGCGATGTTG -> TGCGATGTTGC
GTGCGGCGGTT -> TGCGGCGGTTG
GTGCGGGAACG -> TGCGGGAACGA
GTGCGTTATCA -> TGCGTTATCAC
GTGCTATACAA -> TGCTATACAAA
GTGCTATCGCG -> TGCTATCGCGT
GTGCTCGGCGA -> TGCTCGGCGAG
GTGGAAAGACA -> TGGAAAGACAG
GTGGCCGGTAC -> TGGCCGGTACT
GTGGCCTGCGT -> TGGCCTGCGTT
GTGGGAGATGA -> TGGGAGATGAG
GTGGGTAGAAT -> TGGGTAGAATT
GTGTAACCCCT -> TGTAACCCCTC
GTGTATAGGCA -> TGTATAGGCAT
GTGTATCTCGG -> TGTATCTCGGG
GTGTCACGGCC -> TGTCACGGCCT
GTGTCAGTGAG -> TGTCAGTGAGG
GTGTGAGATTG -> TGTGAGATTGG
GTGTGAGGCAG -> TGTGAGGCAGC
GTGTGCCCTGG -> TGTGCCCTGGG
GTTAAAGGTTG -> TTAAAGGTTGA
GTTAATACTAT -> TTAATACTATC
GTTACTCTACT -> TTACTCTACTA
GTTAGGGTACA -> TTAGGGTACAC
GTTAGTCCCAG -> TTAGTCCCAGA
GTTATCACGCT -> TTATCACGCTC
GTTATGAGTTC -> TTATGAGTTCA
GTTATGTCTGT -> TTATGTCTGTT
GTTCATCTTGG -> TTCATCTTGGT
GTTCATGCAAT -> TTCATGCAATC
GTTCCAACGGC -> TTCCAACGGCA
GTTCCGATTAA -> TTCCGATTAAG
GTTCGTGCGGG -> TTCGTGCGGGA
GTTGAAGTAGC -> TTGAAGTAGCA
GTTGACAAGTG -> TTGACAAGTGT
GTTGACGACTC -> TTGACGACTCT
GTTGATGACAC -> TTGATGACACG
GTTGCCGCTCG -> TTGCCGCTCGG
GTTGCGACCAA -> TTGCGACCAAC
GTTGCGCGAAG -> TTGCGCGAAGA
GTTGCGCGAGC -> TTGCGCGAGCT
GTTGGATTAAC -> TTGGATTAACG
GTTGGCCAAAA -> TTGGCCAAAAT
GTTGGTTTCCC -> TTGGTTTCCCA
GTTGTACACCA -> TTGTACACCAC
GTTGTCCGGGG -> TTGTCCGGGGG
GTTGTCTCCTC -> TTGTCTCCTCA
GTTGTTTCAAT -> TTGTTTCAATA
GTTTCAATAAA -> TTTCAATAAAC
GTTTCACGCAG -> TTTCACGCAGG
GTTTCATCAGG -> TTTCATCAGGG
GTTTCCCAGGC -> TTTCCCAGGCT
GTTTCCGTGAC -> TTTCCGTGACC
GTTTCCTATTG -> TTTCCTATTGA
GTTTCGTTTCA -> TTTCGTTTCAC
GTTTCTTTTTG -> TTTCTTTTTGG
GTTTTCCAGTC -> TTTTCCAGTCG
GTTTTTCGTAA -> TTTTTCGTAAT
TAAAAATCACC -> AAAAATCACCG
TAAAAATGCCT -> AAAAATGCCTT
TAAACACTTAG -> AAACACTTAGC
TAAACCAGTTG -> AAACCAGTTGG
TAAAGCGACAT -> AAAGCGACATC
TAAAGGTTGAT -> AAAGGTTGATG
TAAAGTGCTAT -> AAAGTGCTATC
TAAAGTTGCGC -> AAAGTTGCGCG
TAAATGCGACT -> AAATGCGACTA
TAACCACTTCC -> AACCACTTCCC
TAACCCCTCTG -> AACCCCTCTGT
TAACGATCTAC -> AACGATCTACT
TAACGCGACAC -> AACGCGACACT
TAACTAATGGC -> AACTAATGGCA
TAACTGAAATG -> AACTGAAATGA
TAAGAAATGGG -> AAGAAATGGGC
TAAGATAAGGA -> AAGATAAGGAT
TAAGCACCTGT -> AAGCACCTGTG
TAAGGATTATG -> AAGGATTATGG
TAAGTCAGTCG -> AAGTCAGTCGA
TAATACTATCT -> AATACTATCTA
TAATCCATTAG -> AATCCATTAGT
TAATCCCATCA -> AATCCCATCAC
TAATGATAACC -> AATGATAACCA
TAATGGCAAGG -> AATGGCAAGGA
TAATTTGGCAC -> AATTTGGCACG
TACAAATCTAA -> ACAAATCTAAA
TACACCACAAG -> ACACCACAAGA
TACACCCGTAA -> ACACCCGTAAA
TACACTGGACG -> ACACTGGACGA
TACAGATGTTC -> ACAGATGTTCC
TACAGCATCGA -> ACAGCATCGAC
TACAGCGGGGT -> ACAGCGGGGTG
TACCAGGGAAT -> ACCAGGGAATC
TACCAGTGGCC -> ACCAGTGGCCG
TACCCCTTGCC -> ACCCCTTGCCG
TACCCTTAGTA -> ACCCTTAGTAG
TACCGTAGAGT -> ACCGTAGAGTC
TACCGTGCGGC -> ACCGTGCGGCG
TACCTTAACTG -> ACCTTAACTGA
TACCTTAGAGC -> ACCTTAGAGCG
TACGACCACAT -> ACGACCACATT
TACGCTTCAAA -> ACGCTTCAAAG
TACGTAACTAA -> ACGTAACTAAT
TACTACCGTGC -> ACTACCGTGCG
TACTATCTAAA -> ACTATCTAAAT
TACTATCTTCA -> ACTATCTTCAT
TACTCAAAGGC -> ACTCAAAGGCG
TACTCTACTAC -> ACTCTACTACC
TACTGAAAGGC -> ACTGAAAGGCG
TACTGTTTCAT -> ACTGTTTCATC
TACTTGGGCAA -> ACTTGGGCAAT
TAGAACGTATA -> AGAACGTATAA
TAGAATTACCC -> AGAATTACCCT
TAGACCCTAAG -> AGACCCTAAGC
TAGACTTCGGA -> AGACTTCGGAC
TAGAGAAGGTG -> AGAGAAGGTGC
TAGAGACATCC -> AGAGACATCCC
TAGAGCCAACC -> AGAGCCAACCC
TAGAGCGACTT -> AGAGCGACTTG
TAGAGGGGTAC -> AGAGGGGTACC
TAGAGGTTCGT -> AGAGGTTCGTG
TAGAGTCAAAG -> AGAGTCAAAGC
TAGAGTTCCGA -> AGAGTTCCGAT
TAGATGGGTTA -> AGATGGGTTAG
TAGCAACGCCA -> AGCAACGCCAC
TAGCACGCCGC -> AGCACGCCGCA
TAGCAGGTACC -> AGCAGGTACCC
TAGCATTAGTA -> AGCATTAGTAC
TAGCCTGTCCT -> AGCCTGTCCTT
TAGCGACAGGA -> AGCGACAGGAA
TAGGAGTAAAG -> AGGAGTAAAGC
TAGGCATAGAC -> AGGCATAGACT
TAGGCCACAGT -> AGGCCACAGTT
TAGGCCGATTG -> AGGCCGATTGA
TAGGCGCACTT -> AGGCGCACTTT
TAGGGCAGCAG -> AGGGCAGCAGG
TAGGGTACACT -> AGGGTACACTG
TAGTACACCCG -> AGTACACCCGT
TAGTACTGAAA -> AGTACTGAAAG
TAGTAGAGAAG -> AGTAGAGAAGG
TAGTATAGAGG -> AGTATAGAGGT
TAGTCAGAGTC -> AGTCAGAGTCC
TAGTCCCAGAG -> AGTCCCAGAGA
TATAAAAATGC -> ATAAAAATGCC
TATACAAATCT -> ATACAAATCTA
TATAGAGGTTC -> ATAGAGGTTCG
TATAGGCATAG -> ATAGGCATAGA
TATAGGGCAGC -> ATAGGGCAGCA
TATATGTAGAT -> ATATGTAGATG
TATCACGCTCA -> ATCACGCTCAA
TATCCGTCCGA -> ATCCGTCCGAT
TATCGCGTTAA -> ATCGCGTTAAT
TATCGGACGAC -> ATCGGACGACA
TATCGGGATTG -> ATCGGGATTGA
TATCGGGTTGT -> ATCGGGTTGTC
TATCGTCCGCG -> ATCGTCCGCGA
TATCTAAATGC -> ATCTAAATGCG
TATCTCGGGCC -> ATCTCGGGCCG
TATCTTCATGA -> ATCTTCATGAC
TATGAGTTCAT -> ATGAGTTCATC
TATGCGGTGCG -> ATGCGGTGCGA
TATGGAGGGTG -> ATGGAGGGTGG
TATGGATTGTT -> ATGGATTGTTT
TATGTAGATGG -> ATGTAGATGGG
TATGTCTGTTG -> ATGTCTGTTGT
TATGTGTGCCC -> ATGTGTGCCCT
TATTCCACTGC -> ATTCCACTGCT
TATTGATCACT -> ATTGATCACTA
TATTGTCACGC -> ATTGTCACGCA
TATTTACAGCG -> ATTTACAGCGG
TATTTTCAGTC -> ATTTTCAGTCG
TCAAACCACTC -> CAAACCACTCT
TCAAAGAGGGT -> CAAAGAGGGTT
TCAAAGCATCC -> CAAAGCATCCC
TCAAAGCGTAA -> CAAAGCGTAAT
TCAAAGGCGCC -> CAAAGGCGCCC
TCAAGTAGGCC -> CAAGTAGGCCA
TCAATAAACCA -> CAATAAACCAG
TCACAGTGGAA -> CACAGTGGAAA
TCACCCTCAGA -> CACCCTCAGAT
TCACCGGATAG -> CACCGGATAGT
TCACGAACATA -> CACGAACATAA
TCACGCACCAA -> CACGCACCAAG
TCACGCAGGCC -> CACGCAGGCCT
TCACGCTCAAG -> CACGCTCAAGT
TCACGGCCTGA -> CACGGCCTGAG
TCACGTTTTTC -> CACGTTTTTCG
TCACTAATCCA -> CACTAATCCAT
TCAGAGTCCTG -> CAGAGTCCTGA
TCAGATTTCTC -> CAGATTTCTCG
TCAGCATTGTA -> CAGCATTGTAT
TCAGGGAAAAA -> CAGGGAAAAAC
TCAGGGCGAAA -> CAGGGCGAAAC
TCAGTCGAGCC -> CAGTCGAGCCC
TCAGTCGCTTG -> CAGTCGCTTGA
TCAGTGACGGT -> CAGTGACGGTG
TCAGTGAGGTG -> CAGTGAGGTGT
TCATCAGGGAA -> CATCAGGGAAA
TCATCTTGGTT -> CATCTTGGTTA
TCATGACGTAG -> CATGACGTAGA
TCATGACTGAA -> CATGACTGAAT
TCATGCAATCT -> CATGCAATCTC
TCATTCAAAGA -> CATTCAAAGAG
TCCAACGGCAC -> CCAACGGCACC
TCCACTGCTGG -> CCACTGCTGGC
TCCAGCTTGGT -> CCAGCTTGGTT
TCCAGTCGTGT -> CCAGTCGTGTA
TCCATTAGTAT -> CCATTAGTATA
TCCCAGAGAGA -> CCCAGAGAGAA
TCCCAGCGGAG -> CCCAGCGGAGG
TCCCAGGCTGG -> CCCAGGCTGGG
TCCCATCACGT -> CCCATCACGTT
TCCCCGACCCT -> CCCCGACCCTA
TCCCCGGGAGA -> CCCCGGGAGAC
TCCCGCGCTAT -> CCCGCGCTATA
TCCCGGTGGGT -> CCCGGTGGGTA
TCCCGTACTCA -> CCCGTACTCAA
TCCGATAGCCT -> CCGATAGCCTG
TCCGATTAAGA -> CCGATTAAGAA
TCCGCGAGCGT -> CCGCGAGCGTC
TCCGGGGGGTA -> CCGGGGGGTAT
TCCGGTTGCCG -> CCGGTTGCCGC
TCCGTCCGATA -> CCGTCCGATAG
TCCGTGACCCT -> CCGTGACCCTG
TCCGTTTCTTT -> CCGTTTCTTTT
TCCTATTGATC -> CCTATTGATCA
TCCTCATTCAA -> CCTCATTCAAA
TCCTCTTACCA -> CCTCTTACCAG
TCCTGACTGTT -> CCTGACTGTTG
TCCTTAGCACG -> CCTTAGCACGC
TCCTTTAGACC -> CCTTTAGACCC
TCGACCACGCT -> CGACCACGCTC
TCGACCAGTGC -> CGACCAGTGCT
TCGAGATGATG -> CGAGATGATGA
TCGAGCATGGC -> CGAGCATGGCT
TCGAGCCCAGA -> CGAGCCCAGAC
TCGAGGCGCCT -> CGAGGCGCCTG
TCGAGTTGTCT -> CGAGTTGTCTC
TCGCAATCTCG -> CGCAATCTCGA
TCGCACCAAAC -> CGCACCAAACA
TCGCATAGCAA -> CGCATAGCAAC
TCGCATTACAG -> CGCATTACAGA
TCGCCCACAGT -> CGCCCACAGTG
TCGCGTGAGCT -> CGCGTGAGCTC
TCGCGTTAATA -> CGCGTTAATAC
TCGCTTGAGAT -> CGCTTGAGATA
TCGGACGACAT -> CGGACGACATC
TCGGACGAGCT -> CGGACGAGCTA
TCGGCGAGCAT -> CGGCGAGCATG
TCGGGATTGAG -> CGGGATTGAGT
TCGGGCCGCGA -> CGGGCCGCGAT
TCGGGCTTCTG -> CGGGCTTCTGC
TCGGGTTGTCC -> CGGGTTGTCCG
TCGTAATTTGG -> CGTAATTTGGC
TCGTCCGCGAG -> CGTCCGCGAGC
TCGTCGCCCAC -> CGTCGCCCACA
TCGTGAGTTGT -> CGTGAGTTGTT
TCGTGCCTTCC -> CGTGCCTTCCT
TCGTGCGGGAA -> CGTGCGGGAAC
TCGTGTAACCC -> CGTGTAACCCC
TCGTTTCACGC -> CGTTTCACGCA
TCTAAACACTT -> CTAAACACTTA
TCTAAATGCGA -> CTAAATGCGAC
TCTAAGATAAG -> CTAAGATAAGG
TCTAAGTCAGT -> CTAAGTCAGTC
TCTACGACCAC -> CTACGACCACA
TCTACTACCGT -> CTACTACCGTG
TCTACTTGGGC -> CTACTTGGGCA
TCTAGAACGTA -> CTAGAACGTAT
TCTAGAGCCAA -> CTAGAGCCAAC
TCTAGGAGTAA -> CTAGGAGTAAA
TCTATTCCACT -> CTATTCCACTG
TCTCCTCATTC -> CTCCTCATTCA
TCTCGAGCATG -> CTCGAGCATGG
TCTCGAGTTGT -> CTCGAGTTGTC
TCTCGCAATCT -> CTCGCAATCTC
TCTCGCATAGC -> CTCGCATAGCA
TCTCGGGCCGC -> CTCGGGCCGCG
TCTGCACGGTT -> CTGCACGGTTT
TCTGCCTCGTG -> CTGCCTCGTGA
TCTGCGGAAGG -> CTGCGGAAGGT
TCTGCTAGAGT -> CTGCTAGAGTT
TCTGTTGTACA -> CTGTTGTACAC
TCTGTTTCGTT -> CTGTTTCGTTT
TCTTACCAGGG -> CTTACCAGGGA
TCTTCAGTGAC -> CTTCAGTGACG
TCTTCATGACG -> CTTCATGACGT
TCTTCGCACCA -> CTTCGCACCAA
TCTTCGCATTA -> CTTCGCATTAC
TCTTCTTTCCA -> CTTCTTTCCAG
TCTTGGGAGCA -> CTTGGGAGCAT
TCTTGGTTAAA -> CTTGGTTAAAG
TCTTTCCAGCT -> CTTTCCAGCTT
TCTTTTTGGCG -> CTTTTTGGCGG
TGAAAGGCGTC -> GAAAGGCGTCC
TGAAATGACGG -> GAAATGACGGG
TGAAGTAGCAT -> GAAGTAGCATT
TGAAGTCCCGT -> GAAGTCCCGTA
TGAATATCGGG -> GAATATCGGGT
TGAATTCGTCG -> GAATTCGTCGC
TGACAAGTGTC -> GACAAGTGTCA
TGACACGTGAC -> GACACGTGACC
TGACCAGCCGA -> GACCAGCCGAA
TGACCCGGGTC -> GACCCGGGTCT
TGACCCTGGCC -> GACCCTGGCCT
TGACGACTCTA -> GACGACTCTAA
TGACGGGGGGG -> GACGGGGGGGC
TGACGGTGTAT -> GACGGTGTATA
TGACGTAGAGG -> GACGTAGAGGG
TGACTGAATTC -> GACTGAATTCG
TGACTGGTGCG -> GACTGGTGCGT
TGACTGTTGAC -> GACTGTTGACG
TGAGAAACACC -> GAGAAACACCG
TGAGAAGATGA -> GAGAAGATGAC
TGAGATAAAGT -> GAGATAAAGTT
TGAGATTGGTA -> GAGATTGGTAG
TGAGCCCGACC -> GAGCCCGACCT
TGAGCTCCCAG -> GAGCTCCCAGC
TGAGGCAGCTT -> GAGGCAGCTTC
TGAGGTGTCAC -> GAGGTGTCACG
TGAGTTCATCT -> GAGTTCATCTT
TGAGTTGCGCG -> GAGTTGCGCGA
TGAGTTGTTTC -> GAGTTGTTTCA
TGATAACCACT -> GATAACCACTT
TGATACCTTAA -> GATACCTTAAC
TGATAGGCGCA -> GATAGGCGCAC
TGATATCGGAC -> GATATCGGACG
TGATATGCGGT -> GATATGCGGTG
TGATCACTAAT -> GATCACTAATC
TGATGAAGTCC -> GATGAAGTCCC
TGATGACACGT -> GATGACACGTG
TGCAACAATGC -> GCAACAATGCT
TGCAATCTCGA -> GCAATCTCGAG
TGCACGGTTTT -> GCACGGTTTTC
TGCCCTGGGGG -> GCCCTGGGGGT
TGCCGAATCTT -> GCCGAATCTTC
TGCCGCTCGGG -> GCCGCTCGGGC
TGCCGGCAAAG -> GCCGGCAAAGC
TGCCTCGTGAG -> GCCTCGTGAGT
TGCCTTCCTCT -> GCCTTCCTCTT
TGCCTTGTGTA -> GCCTTGTGTAT
TGCGACCAACC -> GCGACCAACCG
TGCGACTACCG -> GCGACTACCGT
TGCGATGTTGC -> GCGATGTTGCG
TGCGCGAAGAG -> GCGCGAAGAGG
TGCGCGAGCTC -> GCGCGAGCTCT
TGCGGAAGGTG -> GCGGAAGGTGT
TGCGGCGGTTG -> GCGGCGGTTGG
TGCGGGAACGA -> GCGGGAACGAT
TGCGGTGCGAT -> GCGGTGCGATG
TGCGTTATCAC -> GCGTTATCACG
TGCGTTGACAA -> GCGTTGACAAG
TGCTAACGCGA -> GCTAACGCGAC
TGCTAGAGTTC -> GCTAGAGTTCC
TGCTATACAAA -> GCTATACAAAT
TGCTATCGCGT -> GCTATCGCGTT
TGCTCGGCGAG -> GCTCGGCGAGC
TGCTGGCTCTC -> GCTGGCTCTCG
TGCTTAGTCAG -> GCTTAGTCAGA
TGGAAAGACAG -> GGAAAGACAGC
TGGACGACATA -> GGACGACATAT
TGGAGGGTGGG -> GGAGGGTGGGA
TGGATTAACGA -> GGATTAACGAT
TGGATTGTTTC -> GGATTGTTTCC
TGGCAAGGAGT -> GGCAAGGAGTT
TGGCACGTTCA -> GGCACGTTCAT
TGGCCAAAATT -> GGCCAAAATTG
TGGCCGGTACT -> GGCCGGTACTG
TGGCCTGATAT -> GGCCTGATATG
TGGCCTGCGTT -> GGCCTGCGTTG
TGGCGGTTGGA -> GGCGGTTGGAT
TGGCTCTACGA -> GGCTCTACGAC
TGGCTCTCGCA -> GGCTCTCGCAA
TGGGAGATGAG -> GGGAGATGAGA
TGGGAGCATAC -> GGGAGCATACG
TGGGCAATTCA -> GGGCAATTCAC
TGGGCAATTCG -> GGGCAATTCGA
TGGGCCCACTA -> GGGCCCACTAC
TGGGCCCTGCT -> GGGCCCTGCTA
TGGGGGTCAGC -> GGGGGTCAGCA
TGGGTAGAATT -> GGGTAGAATTA
TGGGTTAGTCC -> GGGTTAGTCCC
TGGTAGGCCGA -> GGTAGGCCGAT
TGGTCCGGTTG -> GGTCCGGTTGC
TGGTGCGTTAT -> GGTGCGTTATC
TGGTTAAAGGT -> GGTTAAAGGTT
TGGTTATGTCT -> GGTTATGTCTG
TGGTTTCCCAG -> GGTTTCCCAGG
TGTAACCCCTC -> GTAACCCCTCT
TGTACACCACA -> GTACACCACAA
TGTAGATGGGT -> GTAGATGGGTT
TGTATAGGCAT -> GTATAGGCATA
TGTATCGGGAT -> GTATCGGGATT
TGTATCTCGGG -> GTATCTCGGGC
TGTCACGCACC -> GTCACGCACCA
TGTCACGGCCT -> GTCACGGCCTG
TGTCAGTGAGG -> GTCAGTGAGGT
TGTCCCGCGCT -> GTCCCGCGCTA
TGTCCGGGGGG -> GTCCGGGGGGT
TGTCCTTAGCA -> GTCCTTAGCAC
TGTCTCCTCAT -> GTCTCCTCATT
TGTCTGTTGTA -> GTCTGTTGTAC
TGTGAATATCG -> GTGAATATCGG
TGTGAGATTGG -> GTGAGATTGGT
TGTGAGGCAGC -> GTGAGGCAGCT
TGTGCCCTGGG -> GTGCCCTGGGG
TGTGGCCTGCG -> GTGGCCTGCGT
TGTGTATCTCG -> GTGTATCTCGG
TGTGTGCCCTG -> GTGTGCCCTGG
TGTTATGAGTT -> GTTATGAGTTC
TGTTCCAACGG -> GTTCCAACGGC
TGTTGACGACT -> GTTGACGACTC
TGTTGCGACCA -> GTTGCGACCAA
TGTTGTACACC -> GTTGTACACCA
TGTTTCAATAA -> GTTTCAATAAA
TGTTTCATCAG -> GTTTCATCAGG
TGTTTCCGTGA -> GTTTCCGTGAC
TGTTTCGTTTC -> GTTTCGTTTCA
TTAAAGGTTGA -> TAAAGGTTGAT
TTAACGATCTA -> TAACGATCTAC
TTAACTGAAAT -> TAACTGAAATG
TTAAGAAATGG -> TAAGAAATGGG
TTAATACTATC -> TAATACTATCT
TTACAGATGTT -> TACAGATGTTC
TTACAGCGGGG -> TACAGCGGGGT
TTACCAGGGAA -> TACCAGGGAAT
TTACCCTTAGT -> TACCCTTAGTA
TTACTCTACTA -> TACTCTACTAC
TTAGACCCTAA -> TAGACCCTAAG
TTAGAGCGACT -> TAGAGCGACTT
TTAGCACGCCG -> TAGCACGCCGC
TTAGCAGGTAC -> TAGCAGGTACC
TTAGCGACAGG -> TAGCGACAGGA
TTAGGGTACAC -> TAGGGTACACT
TTAGTACACCC -> TAGTACACCCG
TTAGTAGAGAA -> TAGTAGAGAAG
TTAGTATAGAG -> TAGTATAGAGG
TTAGTCAGAGT -> TAGTCAGAGTC
TTAGTCCCAGA -> TAGTCCCAGAG
TTATCACGCTC -> TATCACGCTCA
TTATGAGTTCA -> TATGAGTTCAT
TTATGGATTGT -> TATGGATTGTT
TTATGTCTGTT -> TATGTCTGTTG
TTATTGTCACG -> TATTGTCACGC
TTCAAAGAGGG -> TCAAAGAGGGT
TTCAAAGCATC -> TCAAAGCATCC
TTCAATAAACC -> TCAATAAACCA
TTCACAGTGGA -> TCACAGTGGAA
TTCACGCAGGC -> TCACGCAGGCC
TTCAGGGCGAA -> TCAGGGCGAAA
TTCAGTCGCTT -> TCAGTCGCTTG
TTCAGTGACGG -> TCAGTGACGGT
TTCATCAGGGA -> TCATCAGGGAA
TTCATCTTGGT -> TCATCTTGGTT
TTCATGACGTA -> TCATGACGTAG
TTCATGACTGA -> TCATGACTGAA
TTCATGCAATC -> TCATGCAATCT
TTCCAACGGCA -> TCCAACGGCAC
TTCCACTGCTG -> TCCACTGCTGG
TTCCAGCTTGG -> TCCAGCTTGGT
TTCCAGTCGTG -> TCCAGTCGTGT
TTCCCAGGCTG -> TCCCAGGCTGG
TTCCCCGACCC -> TCCCCGACCCT
TTCCGATTAAG -> TCCGATTAAGA
TTCCGTGACCC -> TCCGTGACCCT
TTCCTATTGAT -> TCCTATTGATC
TTCCTCTTACC -> TCCTCTTACCA
TTCGACCAGTG -> TCGACCAGTGC
TTCGCACCAAA -> TCGCACCAAAC
TTCGCATTACA -> TCGCATTACAG
TTCGCGTGAGC -> TCGCGTGAGCT
TTCGGACGAGC -> TCGGACGAGCT
TTCGTAATTTG -> TCGTAATTTGG
TTCGTCGCCCA -> TCGTCGCCCAC
TTCGTGCGGGA -> TCGTGCGGGAA
TTCGTTTCACG -> TCGTTTCACGC
TTCTCGCATAG -> TCTCGCATAGC
TTCTGCGGAAG -> TCTGCGGAAGG
TTCTGCTAGAG -> TCTGCTAGAGT
TTCTTTCCAGC -> TCTTTCCAGCT
TTCTTTTTGGC -> TCTTTTTGGCG
TTGAAGTAGCA -> TGAAGTAGCAT
TTGACAAGTGT -> TGACAAGTGTC
TTGACGACTCT -> TGACGACTCTA
TTGACTGGTGC -> TGACTGGTGCG
TTGAGAAGATG -> TGAGAAGATGA
TTGAGATAAAG -> TGAGATAAAGT
TTGAGTTGCGC -> TGAGTTGCGCG
TTGATATCGGA -> TGATATCGGAC
TTGATCACTAA -> TGATCACTAAT
TTGATGACACG -> TGATGACACGT
TTGCCGAATCT -> TGCCGAATCTT
TTGCCGCTCGG -> TGCCGCTCGGG
TTGCCGGCAAA -> TGCCGGCAAAG
TTGCGACCAAC -> TGCGACCAACC
TTGCGCGAAGA -> TGCGCGAAGAG
TTGCGCGAGCT -> TGCGCGAGCTC
TTGGATTAACG -> TGGATTAACGA
TTGGCACGTTC -> TGGCACGTTCA
TTGGCCAAAAT -> TGGCCAAAATT
TTGGCGGTTGG -> TGGCGGTTGGA
TTGGGAGCATA -> TGGGAGCATAC
TTGGGCAATTC -> TGGGCAATTCA
TTGGGCCCACT -> TGGGCCCACTA
TTGGTAGGCCG -> TGGTAGGCCGA
TTGGTCCGGTT -> TGGTCCGGTTG
TTGGTTAAAGG -> TGGTTAAAGGT
TTGGTTATGTC -> TGGTTATGTCT
TTGGTTTCCCA -> TGGTTTCCCAG
TTGTACACCAC -> TGTACACCACA
TTGTATCGGGA -> TGTATCGGGAT
TTGTCACGCAC -> TGTCACGCACC
TTGTCCGGGGG -> TGTCCGGGGGG
TTGTCTCCTCA -> TGTCTCCTCAT
TTGTGTATCTC -> TGTGTATCTCG
TTGTTTCAATA -> TGTTTCAATAA
TTGTTTCCGTG -> TGTTTCCGTGA
TTTACAGCGGG -> TTACAGCGGGG
TTTAGACCCTA -> TTAGACCCTAA
TTTCAATAAAC -> TTCAATAAACC
TTTCACGCAGG -> TTCACGCAGGC
TTTCAGTCGCT -> TTCAGTCGCTT
TTTCATCAGGG -> TTCATCAGGGA
TTTCCAGCTTG -> TTCCAGCTTGG
TTTCCAGTCGT -> TTCCAGTCGTG
TTTCCCAGGCT -> TTCCCAGGCTG
TTTCCGTGACC -> TTCCGTGACCC
TTTCCTATTGA -> TTCCTATTGAT
TTTCGCGTGAG -> TTCGCGTGAGC
TTTCGTAATTT -> TTCGTAATTTG
TTTCGTTTCAC -> TTCGTTTCACG
TTTCTCGCATA -> TTCTCGCATAG
TTTCTTTTTGG -> TTCTTTTTGGC
TTTGGCACGTT -> TTGGCACGTTC
TTTGGCGGTTG -> TTGGCGGTTGG
TTTTCAGTCGC -> TTTCAGTCGCT
TTTTCCAGTCG -> TTTCCAGTCGT
TTTTCGTAATT -> TTTCGTAATTT
TTTTGGCGGTT -> TTTGGCGGTTG
TTTTTCGTAAT -> TTTTCGTAATT
TTTTTGGCGGT -> TTTTGGCGGTT
