AAAAAAGGCTTACTGCTTG -> AAAAAGGCTTACTGCTTGC
AAAAAATTGGCAAAGAGTT -> AAAAATTGGCAAAGAGTTC
AAAAATTGGCAAAGAGTTC -> AAAATTGGCAAAGAGTTCG
AAAACCCGAGGTTTGGAGT -> AAACCCGAGGTTTGGAGTT
AAAAGCAGACACCGGGCTC -> AAAGCAGACACCGGGCTCA
AAAATGCTGCTAAGCCCTG -> AAATGCTGCTAAGCCCTGT
AAAATTGGCAAAGAGTTCG -> AAATTGGCAAAGAGTTCGC
AAACACGTCAATTCTTGCG -> AACACGTCAATTCTTGCGC
AAACCCGAGGTTTGGAGTT -> AACCCGAGGTTTGGAGTTG
AAACGACGTTGGGAGGGCG -> AACGACGTTGGGAGGGCGG
AAACGAGGCATCAATTCGT -> AACGAGGCATCAATTCGTT
AAACGCAGTAGAGACCACT -> AACGCAGTAGAGACCACTA
AAACGTTATTATTCATCAT -> AACGTTATTATTCATCATG
AAACTATACTACGCCTTTA -> AACTATACTACGCCTTTAG
AAACTGATTTAAAAGCAGA -> AACTGATTTAAAAGCAGAC
AAAGAAGTTTATCGTTAGC -> AAGAAGTTTATCGTTAGCC
AAAGAGGCAGTATCCGGAC -> AAGAGGCAGTATCCGGACT
AAAGAGTTCGCCGTTTAAG -> AAGAGTTCGCCGTTTAAGC
AAAGATCCGTACCCGAAAA -> AAGATCCGTACCCGAAAAA
AAAGATCTTTCCCTGCTGT -> AAGATCTTTCCCTGCTGTG
AAAGCAGACACCGGGCTCA -> AAGCAGACACCGGGCTCAG
AAAGCGGGCTTTCTACCGA -> AAGCGGGCTTTCTACCGAA
AAAGCGGGTAATTGTTCCT -> AAGCGGGTAATTGTTCCTC
AAAGGATAGGTCACCCCTT -> AAGGATAGGTCACCCCTTG
AAAGGTAGTAGAAGATACA -> AAGGTAGTAGAAGATACAT
AAATACTCTTGTGCTGTGC -> AATACTCTTGTGCTGTGCT
AAATAGGTGGCATCTTGAT -> AATAGGTGGCATCTTGATT
AAATCTACTTGGGGCACCT -> AATCTACTTGGGGCACCTG
AAATGCTGCTAAGCCCTGT -> AATGCTGCTAAGCCCTGTC
AAATTCAGGTTAATGGTTA -> AATTCAGGTTAATGGTTAC
AAATTCATTTCAGAGCATA -> AATTCATTTCAGAGCATAG
AAATTGGCAAAGAGTTCGC -> AATTGGCAAAGAGTTCGCC
AAATTTCCCTCGTCCGAAG -> AATTTCCCTCGTCCGAAGA
AAATTTGTCTTATTTCGGC -> AATTTGTCTTATTTCGGCT
AACAAACGTTATTATTCAT -> ACAAACGTTATTATTCATC
AACAACATAGCCCGGTTAC -> ACAACATAGCCCGGTTACG
AACAACGCCGCCAGTCAAC -> ACAACGCCGCCAGTCAACA
AACAATACCCATTATATAT -> ACAATACCCATTATATATG
AACACGTCAATTCTTGCGC -> ACACGTCAATTCTTGCGCT
AACACTTGTGCGTATTACA -> ACACTTGTGCGTATTACAG
AACATACTAACGGTTTGGA -> ACATACTAACGGTTTGGAG
AACATAGCCCGGTTACGTA -> ACATAGCCCGGTTACGTAC
AACATCGGTTCAGCTTTAA -> ACATCGGTTCAGCTTTAAG
AACATGGCGCGCAAGGATT -> ACATGGCGCGCAAGGATTC
AACCACCGTCAAGAGTTTA -> ACCACCGTCAAGAGTTTAA
AACCACTGGGAGTCTACGT -> ACCACTGGGAGTCTACGTC
AACCCGAGGTTTGGAGTTG -> ACCCGAGGTTTGGAGTTGC
AACCCTGCTCAGCATCCTC -> ACCCTGCTCAGCATCCTCC
AACCGATCAAATAGGTGGC -> ACCGATCAAATAGGTGGCA
AACCTTCAAGAACGCATTC -> ACCTTCAAGAACGCATTCC
AACGAAGCGAACGCTGTCA -> ACGAAGCGAACGCTGTCAA
AACGACGAGAGTTGGGCGG -> ACGACGAGAGTTGGGCGGT
AACGACGTTGGGAGGGCGG -> ACGACGTTGGGAGGGCGGT
AACGAGGCATCAATTCGTT -> ACGAGGCATCAATTCGTTA
AACGCAGTAGAGACCACTA -> ACGCAGTAGAGACCACTAA
AACGCATTCCGTAAGGATG -> ACGCATTCCGTAAGGATGA
AACGCCGCCAGTCAACAAC -> ACGCCGCCAGTCAACAACA
AACGCCGTATGGTGCTTGA -> ACGCCGTATGGTGCTTGAA
AACGCTATAGGTTTCACAG -> ACGCTATAGGTTTCACAGG
AACGCTGTCAACCGATCAA -> ACGCTGTCAACCGATCAAA
AACGGTTTGGAGTTGCGAC -> ACGGTTTGGAGTTGCGACA
AACGTGTAAATTTGTCTTA -> ACGTGTAAATTTGTCTTAT
AACGTGTCAGCGCAACCCT -> ACGTGTCAGCGCAACCCTG
AACGTTATTATTCATCATG -> ACGTTATTATTCATCATGG
AACTAAACGAGGCATCAAT -> ACTAAACGAGGCATCAATT
AACTATACTACGCCTTTAG -> ACTATACTACGCCTTTAGA
AACTATAGCTCCTTCATGA -> ACTATAGCTCCTTCATGAC
AACTCAGCGGGGTCCCAAT -> ACTCAGCGGGGTCCCAATA
AACTGATTTAAAAGCAGAC -> ACTGATTTAAAAGCAGACA
AACTTAGTATAAAACCCGA -> ACTTAGTATAAAACCCGAG
AAGAACGCATTCCGTAAGG -> AGAACGCATTCCGTAAGGA
AAGAAGTGACCCTGGAATA -> AGAAGTGACCCTGGAATAC
AAGAAGTTTATCGTTAGCC -> AGAAGTTTATCGTTAGCCG
AAGAGGCAGTATCCGGACT -> AGAGGCAGTATCCGGACTC
AAGAGTGCGACTTATTTAC -> AGAGTGCGACTTATTTACG
AAGAGTTCGCCGTTTAAGC -> AGAGTTCGCCGTTTAAGCC
AAGAGTTTAAAGATCCGTA -> AGAGTTTAAAGATCCGTAC
AAGATACATGGGGTATCCT -> AGATACATGGGGTATCCTC
AAGATCCGTACCCGAAAAA -> AGATCCGTACCCGAAAAAA
AAGATCTTTCCCTGCTGTG -> AGATCTTTCCCTGCTGTGA,AGATCTTTCCCTGCTGTGA
AAGCAGACACCGGGCTCAG -> AGCAGACACCGGGCTCAGT
AAGCCCATTGGTTATATCA -> AGCCCATTGGTTATATCAA
AAGCCCTGTCTGGGGGACC -> AGCCCTGTCTGGGGGACCA
AAGCCGATGTTTAGTCCAC -> AGCCGATGTTTAGTCCACC
AAGCGAACGCTGTCAACCG -> AGCGAACGCTGTCAACCGA
AAGCGCGCGTGGATACATC -> AGCGCGCGTGGATACATCA
AAGCGCGCTACTTGGCATC -> AGCGCGCTACTTGGCATCC
AAGCGGGCTTTCTACCGAA -> AGCGGGCTTTCTACCGAAT
AAGCGGGTAATTGTTCCTC -> AGCGGGTAATTGTTCCTCT
AAGCGTTCAACTAAACGAG -> AGCGTTCAACTAAACGAGG
AAGCTACTACCAATAGACG -> AGCTACTACCAATAGACGA
AAGCTAGCCCCTCTAGTGA -> AGCTAGCCCCTCTAGTGAA
AAGCTCTTATCCGAACCAC -> AGCTCTTATCCGAACCACC
AAGGAAATACTCTTGTGCT -> AGGAAATACTCTTGTGCTG
AAGGAAGCTCTTATCCGAA -> AGGAAGCTCTTATCCGAAC
AAGGATAGGTCACCCCTTG -> AGGATAGGTCACCCCTTGG
AAGGATGAAACACGTCAAT -> AGGATGAAACACGTCAATT
AAGGATTCTAGCCTACACG -> AGGATTCTAGCCTACACGG
AAGGCAACGTGTCAGCGCA -> AGGCAACGTGTCAGCGCAA
AAGGGGACTTGGAAAGGTA -> AGGGGACTTGGAAAGGTAG
AAGGTAATGAAATTCAGGT -> AGGTAATGAAATTCAGGTT
AAGGTAGTAGAAGATACAT -> AGGTAGTAGAAGATACATG
AAGTGACCCTGGAATACGC -> AGTGACCCTGGAATACGCC
AAGTTTATCGTTAGCCGTT -> AGTTTATCGTTAGCCGTTG
AATACATCTTATTCCCTGG -> ATACATCTTATTCCCTGGG
AATACCATGTAACGCTATA -> ATACCATGTAACGCTATAG
AATACCCACGGCAATTAGG -> ATACCCACGGCAATTAGGG
AATACCCATTATATATGGC -> ATACCCATTATATATGGCG
AATACGCCATCGCAGAGTC -> ATACGCCATCGCAGAGTCT
AATACTCTTGTGCTGTGCT -> ATACTCTTGTGCTGTGCTT
AATACTTCATTCGGCTCAG -> ATACTTCATTCGGCTCAGG
AATAGACGACTCGATGCAA -> ATAGACGACTCGATGCAAA
AATAGGTGGCATCTTGATT -> ATAGGTGGCATCTTGATTT
AATAGTAACTATAGCTCCT -> ATAGTAACTATAGCTCCTT
AATATATTTAAAGAAGTTT -> ATATATTTAAAGAAGTTTA
AATATCAGTCCGAAATTCA -> ATATCAGTCCGAAATTCAT
AATCAATTCGTGGCGGGTA -> ATCAATTCGTGGCGGGTAC
AATCACGACTCAGGAGACA -> ATCACGACTCAGGAGACAT
AATCATACAGCCATCGTGA -> ATCATACAGCCATCGTGAA
AATCATAGATTAATACCAT -> ATCATAGATTAATACCATG
AATCCCGCTAGTGCGGGTC -> ATCCCGCTAGTGCGGGTCG
AATCCGGACTCACTAAAAT -> ATCCGGACTCACTAAAATG
AATCTACTTGGGGCACCTG -> ATCTACTTGGGGCACCTGA
AATGAAATTCAGGTTAATG -> ATGAAATTCAGGTTAATGG
AATGATCTAAGAAGTGACC -> ATGATCTAAGAAGTGACCC
AATGCACGGTAGACAGGGT -> ATGCACGGTAGACAGGGTT
AATGCTGCTAAGCCCTGTC -> ATGCTGCTAAGCCCTGTCT
AATGGCGGATCCCTTAGTA -> ATGGCGGATCCCTTAGTAG
AATGGTTACCCGGACCCAG -> ATGGTTACCCGGACCCAGA
AATTAGGGCAGCTATAACA -> ATTAGGGCAGCTATAACAT
AATTCAGGTTAATGGTTAC -> ATTCAGGTTAATGGTTACC
AATTCATTTCAGAGCATAG -> ATTCATTTCAGAGCATAGC
AATTCGTGGCGGGTACGAA -> ATTCGTGGCGGGTACGAAC
AATTCGTTATTGCAACGTG -> ATTCGTTATTGCAACGTGT
AATTCTTGCGCTTTTTGAT -> ATTCTTGCGCTTTTTGATG
AATTGGCAAAGAGTTCGCC -> ATTGGCAAAGAGTTCGCCG
AATTGTTCCTCTTAATCCC -> ATTGTTCCTCTTAATCCCG
AATTTCCCTCGTCCGAAGA -> ATTTCCCTCGTCCGAAGAG
AATTTGTCTTATTTCGGCT -> ATTTGTCTTATTTCGGCTC
ACAAACGTTATTATTCATC -> CAAACGTTATTATTCATCA
ACAACATAGCCCGGTTACG -> CAACATAGCCCGGTTACGT
ACAACGCCGCCAGTCAACA -> CAACGCCGCCAGTCAACAA
ACAATACCCATTATATATG -> CAATACCCATTATATATGG
ACACACTGAGGTGAAGATC -> CACACTGAGGTGAAGATCT
ACACCACTTGTCTGTCGCA -> CACCACTTGTCTGTCGCAG
ACACCATTTCTGAAAGATC -> CACCATTTCTGAAAGATCT
ACACCGGGCTCAGTCTCAG -> CACCGGGCTCAGTCTCAGA
ACACGAGACGTCACAGATC -> CACGAGACGTCACAGATCT
ACACGGGGCTTTGACGTTG -> CACGGGGCTTTGACGTTGG
ACACGTCAATTCTTGCGCT -> CACGTCAATTCTTGCGCTT
ACACTGAGGTGAAGATCTT -> CACTGAGGTGAAGATCTTT
ACACTGCTCGATGGAGATC -> CACTGCTCGATGGAGATCT
ACACTTGTGCGTATTACAG -> CACTTGTGCGTATTACAGA
ACAGACATGAGCCTCTTGG -> CAGACATGAGCCTCTTGGT
ACAGATAATCCGGACTCAC -> CAGATAATCCGGACTCACT
ACAGATCTTTCCCTGCTGT -> CAGATCTTTCCCTGCTGTG
ACAGCCATCGTGAAACTGA -> CAGCCATCGTGAAACTGAT
ACAGCCTTGGCATAAGGAA -> CAGCCTTGGCATAAGGAAA
ACAGGCAGGTCTGATGACG -> CAGGCAGGTCTGATGACGA
ACAGGGTTTGGAGTTGCGA -> CAGGGTTTGGAGTTGCGAC
ACAGTCACTGTAACGCCGT -> CAGTCACTGTAACGCCGTA
ACATACTAACGGTTTGGAG -> CATACTAACGGTTTGGAGT
ACATAGCCCGGTTACGTAC -> CATAGCCCGGTTACGTACC
ACATCAAGGTAATGAAATT -> CATCAAGGTAATGAAATTC
ACATCGGTTCAGCTTTAAG -> CATCGGTTCAGCTTTAAGC
ACATCTTATTCCCTGGGAT -> CATCTTATTCCCTGGGATT
ACATCTTCATATTGTCGTC -> CATCTTCATATTGTCGTCA
ACATGAGCCTCTTGGTTTG -> CATGAGCCTCTTGGTTTGG
ACATGGCGCGCAAGGATTC -> CATGGCGCGCAAGGATTCT
ACATGGGGTATCCTCTAAG -> CATGGGGTATCCTCTAAGG
ACATGTAATACATCTTATT -> CATGTAATACATCTTATTC
ACCAATAGACGACTCGATG -> CCAATAGACGACTCGATGC
ACCACATGTAATACATCTT -> CCACATGTAATACATCTTA
ACCACCGTCAAGAGTTTAA -> CCACCGTCAAGAGTTTAAA
ACCACGCCGTCCCACAGAT -> CCACGCCGTCCCACAGATA
ACCACTAACACTTGTGCGT -> CCACTAACACTTGTGCGTA
ACCACTGGGAGTCTACGTC -> CCACTGGGAGTCTACGTCC
ACCACTTGTCTGTCGCAGC -> CCACTTGTCTGTCGCAGCG
ACCAGGGATCTGTTACTAG -> CCAGGGATCTGTTACTAGG
ACCATGTAACGCTATAGGT -> CCATGTAACGCTATAGGTT
ACCATTTCTGAAAGATCTT -> CCATTTCTGAAAGATCTTT
ACCCACGGCAATTAGGGCA -> CCCACGGCAATTAGGGCAG
ACCCAGATTTATATTATGC -> CCCAGATTTATATTATGCC
ACCCATTATATATGGCGTC -> CCCATTATATATGGCGTCC
ACCCCGTTGAATGATCTAA -> CCCCGTTGAATGATCTAAG
ACCCCTTGGAAATTTCCCT -> CCCCTTGGAAATTTCCCTC
ACCCGAAAAAATTGGCAAA -> CCCGAAAAAATTGGCAAAG
ACCCGAATGGCGGATCCCT -> CCCGAATGGCGGATCCCTT
ACCCGAGGTTTGGAGTTGC -> CCCGAGGTTTGGAGTTGCG
ACCCGGACCCAGATTTATA -> CCCGGACCCAGATTTATAT
ACCCTGCTCAGCATCCTCC -> CCCTGCTCAGCATCCTCCA
ACCCTGGAATACGCCATCG -> CCCTGGAATACGCCATCGC
ACCGAATCATACAGCCATC -> CCGAATCATACAGCCATCG
ACCGATCAAATAGGTGGCA -> CCGATCAAATAGGTGGCAT
ACCGGGCTCAGTCTCAGAC -> CCGGGCTCAGTCTCAGACT
ACCGTCAAGAGTTTAAAGA -> CCGTCAAGAGTTTAAAGAT
ACCGTCAGGATCTTAATAT -> CCGTCAGGATCTTAATATA
ACCTGAACAAACGTTATTA -> CCTGAACAAACGTTATTAT
ACCTGATATGGAATCACGA -> CCTGATATGGAATCACGAC
ACCTGTCGCAACATCGGTT -> CCTGTCGCAACATCGGTTC
ACCTTCAAGAACGCATTCC -> CCTTCAAGAACGCATTCCG
ACGAACCTTCAAGAACGCA -> CGAACCTTCAAGAACGCAT
ACGAACGACGAGAGTTGGG -> CGAACGACGAGAGTTGGGC
ACGAAGCGAACGCTGTCAA -> CGAAGCGAACGCTGTCAAC
ACGACGAGAGTTGGGCGGT -> CGACGAGAGTTGGGCGGTC
ACGACGTTGGGAGGGCGGT -> CGACGTTGGGAGGGCGGTA
ACGACTCAGGAGACATCTT -> CGACTCAGGAGACATCTTC
ACGACTCGATGCAAAGAGG -> CGACTCGATGCAAAGAGGC
ACGAGACGTCACAGATCTT -> CGAGACGTCACAGATCTTT
ACGAGAGTTGGGCGGTCTT -> CGAGAGTTGGGCGGTCTTG
ACGAGGCATCAATTCGTTA -> CGAGGCATCAATTCGTTAT
ACGATCGAGGTAAAGCGGG -> CGATCGAGGTAAAGCGGGC
ACGCAGTAGAGACCACTAA -> CGCAGTAGAGACCACTAAC
ACGCATTCCGTAAGGATGA -> CGCATTCCGTAAGGATGAA
ACGCCATCGCAGAGTCTCT -> CGCCATCGCAGAGTCTCTG
ACGCCGCCAGTCAACAACA -> CGCCGCCAGTCAACAACAT
ACGCCGTATGGTGCTTGAA -> CGCCGTATGGTGCTTGAAG
ACGCCGTCCCACAGATAAT -> CGCCGTCCCACAGATAATC
ACGCCTTTAGATCATTACC -> CGCCTTTAGATCATTACCG
ACGCTATAGGTTTCACAGG -> CGCTATAGGTTTCACAGGC
ACGCTGCAAGCTAGCCCCT -> CGCTGCAAGCTAGCCCCTC
ACGCTGTCAACCGATCAAA -> CGCTGTCAACCGATCAAAT
ACGGATTACGGTGAGAAGG -> CGGATTACGGTGAGAAGGG
ACGGCAATTAGGGCAGCTA -> CGGCAATTAGGGCAGCTAT
ACGGGGCTTTGACGTTGGT -> CGGGGCTTTGACGTTGGTA
ACGGTAGACAGGGTTTGGA -> CGGTAGACAGGGTTTGGAG
ACGGTGAGAAGGGGACTTG -> CGGTGAGAAGGGGACTTGG
ACGGTTTGGAGTTGCGACA -> CGGTTTGGAGTTGCGACAC
ACGTACCCGAATGGCGGAT -> CGTACCCGAATGGCGGATC
ACGTCAATTCTTGCGCTTT -> CGTCAATTCTTGCGCTTTT
ACGTCACAGATCTTTCCCT -> CGTCACAGATCTTTCCCTG
ACGTCCGGGGAACTTAGTA -> CGTCCGGGGAACTTAGTAT
ACGTGTAAATTTGTCTTAT -> CGTGTAAATTTGTCTTATT
ACGTGTCAGCGCAACCCTG -> CGTGTCAGCGCAACCCTGC
ACGTTAGTGGCGCTGTCCG -> CGTTAGTGGCGCTGTCCGT
ACGTTATTATTCATCATGG -> CGTTATTATTCATCATGGG
ACGTTGGGAGGGCGGTAAC -> CGTTGGGAGGGCGGTAACT
ACGTTGGTAAAGGATAGGT -> CGTTGGTAAAGGATAGGTC
ACGTTGGTCAGCTGTACCT -> CGTTGGTCAGCTGTACCTG
ACGTTTCTCGCGGACGCTG -> CGTTTCTCGCGGACGCTGC
ACTAAAATGCTGCTAAGCC -> CTAAAATGCTGCTAAGCCC
ACTAAACGAGGCATCAATT -> CTAAACGAGGCATCAATTC
ACTAACACTTGTGCGTATT -> CTAACACTTGTGCGTATTA
ACTAACGGTTTGGAGTTGC -> CTAACGGTTTGGAGTTGCG
ACTACCAATAGACGACTCG -> CTACCAATAGACGACTCGA
ACTACGCCTTTAGATCATT -> CTACGCCTTTAGATCATTA
ACTAGAATCATAGATTAAT -> CTAGAATCATAGATTAATA
ACTAGGCATCGCAATACCC -> CTAGGCATCGCAATACCCA
ACTATACTACGCCTTTAGA -> CTATACTACGCCTTTAGAT
ACTATAGCTCCTTCATGAC -> CTATAGCTCCTTCATGACT
ACTATTTGTGAACAACGCC -> CTATTTGTGAACAACGCCG
ACTCACTAAAATGCTGCTA -> CTCACTAAAATGCTGCTAA
ACTCAGCGGGGTCCCAATA -> CTCAGCGGGGTCCCAATAG
ACTCAGGAGACATCTTCAT -> CTCAGGAGACATCTTCATA
ACTCCACAGCCTTGGCATA -> CTCCACAGCCTTGGCATAA
ACTCGACACCACTTGTCTG -> CTCGACACCACTTGTCTGT
ACTCGATGCAAAGAGGCAG -> CTCGATGCAAAGAGGCAGT
ACTCTTGTGCTGTGCTTCA -> CTCTTGTGCTGTGCTTCAT
ACTGAGGTGAAGATCTTTC -> CTGAGGTGAAGATCTTTCC
ACTGATTTAAAAGCAGACA -> CTGATTTAAAAGCAGACAC
ACTGCGAAACGCAGTAGAG -> CTGCGAAACGCAGTAGAGA
ACTGCTCGATGGAGATCTT -> CTGCTCGATGGAGATCTTT
ACTGGGAGTCTACGTCCGG -> CTGGGAGTCTACGTCCGGG
ACTGTAACGCCGTATGGTG -> CTGTAACGCCGTATGGTGC
ACTTAGTATAAAACCCGAG -> CTTAGTATAAAACCCGAGG
ACTTATTTACGAACGACGA -> CTTATTTACGAACGACGAG
ACTTCATTCGGCTCAGGGG -> CTTCATTCGGCTCAGGGGC
ACTTGCCAACGAAGCGAAC -> CTTGCCAACGAAGCGAACG
ACTTGGAAAGGTAGTAGAA -> CTTGGAAAGGTAGTAGAAG
ACTTGGCATCCTTCTACAG -> CTTGGCATCCTTCTACAGT
ACTTGGGGCACCTGATATG -> CTTGGGGCACCTGATATGG
ACTTGTATATCACCTGAAC -> CTTGTATATCACCTGAACA
ACTTGTCTGTCGCAGCGCC -> CTTGTCTGTCGCAGCGCCG
ACTTGTGCGTATTACAGAC -> CTTGTGCGTATTACAGACA
AGAACCACTGGGAGTCTAC -> GAACCACTGGGAGTCTACG
AGAACGCATTCCGTAAGGA -> GAACGCATTCCGTAAGGAT
AGAAGATACATGGGGTATC -> GAAGATACATGGGGTATCC
AGAAGCGTTCAACTAAACG -> GAAGCGTTCAACTAAACGA
AGAAGGGGACTTGGAAAGG -> GAAGGGGACTTGGAAAGGT
AGAAGTGACCCTGGAATAC -> GAAGTGACCCTGGAATACG
AGAAGTTTATCGTTAGCCG -> GAAGTTTATCGTTAGCCGT
AGAATCATAGATTAATACC -> GAATCATAGATTAATACCA
AGACACCGGGCTCAGTCTC -> GACACCGGGCTCAGTCTCA
AGACAGGGTTTGGAGTTGC -> GACAGGGTTTGGAGTTGCG
AGACATCTTCATATTGTCG -> GACATCTTCATATTGTCGT
AGACATGAGCCTCTTGGTT -> GACATGAGCCTCTTGGTTT
AGACCACTAACACTTGTGC -> GACCACTAACACTTGTGCG
AGACGACTCGATGCAAAGA -> GACGACTCGATGCAAAGAG
AGACGTCACAGATCTTTCC -> GACGTCACAGATCTTTCCC
AGACTTGCCAACGAAGCGA -> GACTTGCCAACGAAGCGAA
AGAGACCACTAACACTTGT -> GAGACCACTAACACTTGTG
AGAGCATAGCTACTATTTG -> GAGCATAGCTACTATTTGT
AGAGGCAGTATCCGGACTC -> GAGGCAGTATCCGGACTCC
AGAGTCTCTGAGGCCTGGG -> GAGTCTCTGAGGCCTGGGG
AGAGTGCGACTTATTTACG -> GAGTGCGACTTATTTACGA
AGAGTTCGCCGTTTAAGCC -> GAGTTCGCCGTTTAAGCCG
AGAGTTGGGCGGTCTTGAC -> GAGTTGGGCGGTCTTGACG
AGAGTTTAAAGATCCGTAC -> GAGTTTAAAGATCCGTACC
AGATAATCCGGACTCACTA -> GATAATCCGGACTCACTAA
AGATACATGGGGTATCCTC -> GATACATGGGGTATCCTCT
AGATCATTACCGTCAGGAT -> GATCATTACCGTCAGGATC
AGATCCGTACCCGAAAAAA -> GATCCGTACCCGAAAAAAT
AGATCTTTCCCTGCTGTGA -> GATCTTTCCCTGCTGTGAG,GATCTTTCCCTGCTGTGAG,GATCTTTCCCTGCTGTGAG,GATCTTTCCCTGCTGTGAG
AGATTAATACCATGTAACG -> GATTAATACCATGTAACGC
AGATTTATATTATGCCGTG -> GATTTATATTATGCCGTGG
AGCAAACTATACTACGCCT -> GCAAACTATACTACGCCTT
AGCAATACTTCATTCGGCT -> GCAATACTTCATTCGGCTC
AGCAGACACCGGGCTCAGT -> GCAGACACCGGGCTCAGTC
AGCAGCAGCCTCTGCGAAG -> GCAGCAGCCTCTGCGAAGC
AGCAGCCTCTGCGAAGCGC -> GCAGCCTCTGCGAAGCGCG
AGCATAGCTACTATTTGTG -> GCATAGCTACTATTTGTGA
AGCATCCTCCACTAGAATC -> GCATCCTCCACTAGAATCA
AGCCAATATCAGTCCGAAA -> GCCAATATCAGTCCGAAAT
AGCCATCGTGAAACTGATT -> GCCATCGTGAAACTGATTT
AGCCCAGCTAAGGAAGCTC -> GCCCAGCTAAGGAAGCTCT
AGCCCATTGGTTATATCAA -> GCCCATTGGTTATATCAAA
AGCCCCTCTAGTGAAATCT -> GCCCCTCTAGTGAAATCTA
AGCCCGGTTACGTACCCGA -> GCCCGGTTACGTACCCGAA
AGCCCTGTCTGGGGGACCA -> GCCCTGTCTGGGGGACCAG
AGCCGATGTTTAGTCCACC -> GCCGATGTTTAGTCCACCA
AGCCGTTGCTCGCCGCCTC -> GCCGTTGCTCGCCGCCTCA
AGCCTACACGGGGCTTTGA -> GCCTACACGGGGCTTTGAC
AGCCTCTGCGAAGCGCGCG -> GCCTCTGCGAAGCGCGCGT
AGCCTCTTGGTTTGGAGTT -> GCCTCTTGGTTTGGAGTTG
AGCCTTGGCATAAGGAAAT -> GCCTTGGCATAAGGAAATA
AGCGAACGCTGTCAACCGA -> GCGAACGCTGTCAACCGAT
AGCGCAACCCTGCTCAGCA -> GCGCAACCCTGCTCAGCAT
AGCGCCGACGGATTACGGT -> GCGCCGACGGATTACGGTG
AGCGCGCGTGGATACATCA -> GCGCGCGTGGATACATCAA
AGCGCGCTACTTGGCATCC -> GCGCGCTACTTGGCATCCT
AGCGGGCTTTCTACCGAAT -> GCGGGCTTTCTACCGAATC
AGCGGGGTCCCAATAGTAA -> GCGGGGTCCCAATAGTAAC
AGCGGGTAATTGTTCCTCT -> GCGGGTAATTGTTCCTCTT
AGCGTTCAACTAAACGAGG -> GCGTTCAACTAAACGAGGC
AGCTAAAAAAGGCTTACTG -> GCTAAAAAAGGCTTACTGC
AGCTAAGGAAGCTCTTATC -> GCTAAGGAAGCTCTTATCC
AGCTACTACCAATAGACGA -> GCTACTACCAATAGACGAC
AGCTACTATTTGTGAACAA -> GCTACTATTTGTGAACAAC
AGCTAGCCCCTCTAGTGAA -> GCTAGCCCCTCTAGTGAAA
AGCTATAACATGGCGCGCA -> GCTATAACATGGCGCGCAA
AGCTCCTTCATGACTCGAC -> GCTCCTTCATGACTCGACA
AGCTCTTATCCGAACCACC -> GCTCTTATCCGAACCACCG
AGCTGAGCAAACTATACTA -> GCTGAGCAAACTATACTAC
AGCTGTACCTGTCGCAACA -> GCTGTACCTGTCGCAACAT
AGCTTTAAGCTACTACCAA -> GCTTTAAGCTACTACCAAT
AGGAAATACTCTTGTGCTG -> GGAAATACTCTTGTGCTGT
AGGAAGCTCTTATCCGAAC -> GGAAGCTCTTATCCGAACC
AGGAGACATCTTCATATTG -> GGAGACATCTTCATATTGT
AGGATAGGTCACCCCTTGG -> GGATAGGTCACCCCTTGGA
AGGATCTTAATATATTTAA -> GGATCTTAATATATTTAAA
AGGATGAAACACGTCAATT -> GGATGAAACACGTCAATTC
AGGATTCTAGCCTACACGG -> GGATTCTAGCCTACACGGG
AGGCAACGTGTCAGCGCAA -> GGCAACGTGTCAGCGCAAC
AGGCAGGTCTGATGACGAT -> GGCAGGTCTGATGACGATC
AGGCAGTATCCGGACTCCA -> GGCAGTATCCGGACTCCAC
AGGCATCAATTCGTTATTG -> GGCATCAATTCGTTATTGC
AGGCATCGCAATACCCACG -> GGCATCGCAATACCCACGG
AGGCCAGTACTTGTATATC -> GGCCAGTACTTGTATATCA
AGGCCTGGGGATGATAGTT -> GGCCTGGGGATGATAGTTA
AGGCTTTATTAGTATTGGT -> GGCTTTATTAGTATTGGTG
AGGGATCTGTTACTAGGCA -> GGGATCTGTTACTAGGCAT
AGGGCAGCTATAACATGGC -> GGGCAGCTATAACATGGCG
AGGGCGGTAACTCAGCGGG -> GGGCGGTAACTCAGCGGGG
AGGGGACTTGGAAAGGTAG -> GGGGACTTGGAAAGGTAGT
AGGGGCAGTTATGGCGGGG -> GGGGCAGTTATGGCGGGGG
AGGGGGCTGAGCTGAGCAA -> GGGGGCTGAGCTGAGCAAA
AGGGTCTAGCAATACTTCA -> GGGTCTAGCAATACTTCAT
AGGGTTTGGAGTTGCGACA -> GGGTTTGGAGTTGCGACAC
AGGTAAAGCGGGCTTTCTA -> GGTAAAGCGGGCTTTCTAC
AGGTAATGAAATTCAGGTT -> GGTAATGAAATTCAGGTTA
AGGTAGTAGAAGATACATG -> GGTAGTAGAAGATACATGG
AGGTCACCCCTTGGAAATT -> GGTCACCCCTTGGAAATTT
AGGTCTGATGACGATCGAG -> GGTCTGATGACGATCGAGG
AGGTGAAGATCTTTCCCTG -> GGTGAAGATCTTTCCCTGC
AGGTGCGCAGCCAATATCA -> GGTGCGCAGCCAATATCAG
AGGTGGCATCTTGATTTTC -> GGTGGCATCTTGATTTTCT
AGGTTAATGGTTACCCGGA -> GGTTAATGGTTACCCGGAC
AGGTTTCACAGGCAGGTCT -> GGTTTCACAGGCAGGTCTG
AGGTTTGGAGTTGCGACAC -> GGTTTGGAGTTGCGACACA
AGTAACTATAGCTCCTTCA -> GTAACTATAGCTCCTTCAT
AGTACTTGTATATCACCTG -> GTACTTGTATATCACCTGA
AGTAGAAGATACATGGGGT -> GTAGAAGATACATGGGGTA
AGTAGAGACCACTAACACT -> GTAGAGACCACTAACACTT
AGTAGCCCAGCTAAGGAAG -> GTAGCCCAGCTAAGGAAGC
AGTATAAAACCCGAGGTTT -> GTATAAAACCCGAGGTTTG
AGTATCCGGACTCCACAGC -> GTATCCGGACTCCACAGCC
AGTATTGGTGAACAATACC -> GTATTGGTGAACAATACCC
AGTCAACAACATAGCCCGG -> GTCAACAACATAGCCCGGT
AGTCACTGTAACGCCGTAT -> GTCACTGTAACGCCGTATG
AGTCCACCACATGTAATAC -> GTCCACCACATGTAATACA
AGTCCGAAATTCATTTCAG -> GTCCGAAATTCATTTCAGA
AGTCTACGTCCGGGGAACT -> GTCTACGTCCGGGGAACTT
AGTCTCAGACTTGCCAACG -> GTCTCAGACTTGCCAACGA
AGTCTCTGAGGCCTGGGGA -> GTCTCTGAGGCCTGGGGAT
AGTGAAATCTACTTGGGGC -> GTGAAATCTACTTGGGGCA
AGTGACCCTGGAATACGCC -> GTGACCCTGGAATACGCCA
AGTGACGTTGGTCAGCTGT -> GTGACGTTGGTCAGCTGTA
AGTGCGACTTATTTACGAA -> GTGCGACTTATTTACGAAC
AGTGCGGGTCGATGCCAAC -> GTGCGGGTCGATGCCAACA
AGTGGCGCTGTCCGTTGGA -> GTGGCGCTGTCCGTTGGAT
AGTTAGGGGGCTGAGCTGA -> GTTAGGGGGCTGAGCTGAG
AGTTATGGCGGGGGACCCC -> GTTATGGCGGGGGACCCCG
AGTTCGCCGTTTAAGCCGA -> GTTCGCCGTTTAAGCCGAT
AGTTGCGACACACTGAGGT -> GTTGCGACACACTGAGGTG
AGTTGCGACACCATTTCTG -> GTTGCGACACCATTTCTGA
AGTTGCGACACGAGACGTC -> GTTGCGACACGAGACGTCA
AGTTGCGACACTGCTCGAT -> GTTGCGACACTGCTCGATG
AGTTGGGCGGTCTTGACGT -> GTTGGGCGGTCTTGACGTT
AGTTTAAAGATCCGTACCC -> GTTTAAAGATCCGTACCCG
AGTTTATCGTTAGCCGTTG -> GTTTATCGTTAGCCGTTGC
ATAAAACCCGAGGTTTGGA -> TAAAACCCGAGGTTTGGAG
ATAACATGGCGCGCAAGGA -> TAACATGGCGCGCAAGGAT
ATAAGGAAATACTCTTGTG -> TAAGGAAATACTCTTGTGC
ATAATCAATTCGTGGCGGG -> TAATCAATTCGTGGCGGGT
ATAATCCGGACTCACTAAA -> TAATCCGGACTCACTAAAA
ATACAGCCATCGTGAAACT -> TACAGCCATCGTGAAACTG
ATACATCAAGGTAATGAAA -> TACATCAAGGTAATGAAAT
ATACATCTTATTCCCTGGG -> TACATCTTATTCCCTGGGA
ATACATGGGGTATCCTCTA -> TACATGGGGTATCCTCTAA
ATACCATGTAACGCTATAG -> TACCATGTAACGCTATAGG
ATACCCACGGCAATTAGGG -> TACCCACGGCAATTAGGGC
ATACCCATTATATATGGCG -> TACCCATTATATATGGCGT
ATACGCCATCGCAGAGTCT -> TACGCCATCGCAGAGTCTC
ATACTAACGGTTTGGAGTT -> TACTAACGGTTTGGAGTTG
ATACTACGCCTTTAGATCA -> TACTACGCCTTTAGATCAT
ATACTCTTGTGCTGTGCTT -> TACTCTTGTGCTGTGCTTC
ATACTTCATTCGGCTCAGG -> TACTTCATTCGGCTCAGGG
ATAGACGACTCGATGCAAA -> TAGACGACTCGATGCAAAG
ATAGATTAATACCATGTAA -> TAGATTAATACCATGTAAC
ATAGCCCGGTTACGTACCC -> TAGCCCGGTTACGTACCCG
ATAGCTACTATTTGTGAAC -> TAGCTACTATTTGTGAACA
ATAGCTCCTTCATGACTCG -> TAGCTCCTTCATGACTCGA
ATAGGTCACCCCTTGGAAA -> TAGGTCACCCCTTGGAAAT
ATAGGTGGCATCTTGATTT -> TAGGTGGCATCTTGATTTT
ATAGGTTTCACAGGCAGGT -> TAGGTTTCACAGGCAGGTC
ATAGTAACTATAGCTCCTT -> TAGTAACTATAGCTCCTTC
ATAGTTAGGGGGCTGAGCT -> TAGTTAGGGGGCTGAGCTG
ATATATGGCGTCCAGCTAA -> TATATGGCGTCCAGCTAAA
ATATATTTAAAGAAGTTTA -> TATATTTAAAGAAGTTTAT
ATATCAAAGCGGGTAATTG -> TATCAAAGCGGGTAATTGT
ATATCACCTGAACAAACGT -> TATCACCTGAACAAACGTT
ATATCAGTCCGAAATTCAT -> TATCAGTCCGAAATTCATT
ATATGAGGCTTTATTAGTA -> TATGAGGCTTTATTAGTAT
ATATGGAATCACGACTCAG -> TATGGAATCACGACTCAGG
ATATGGCGTCCAGCTAAAA -> TATGGCGTCCAGCTAAAAA
ATATTATGCCGTGGGTGTC -> TATTATGCCGTGGGTGTCT
ATATTGTCGTCACGTTAGT -> TATTGTCGTCACGTTAGTG
ATATTTAAAGAAGTTTATC -> TATTTAAAGAAGTTTATCG
ATCAAAGCGGGTAATTGTT -> TCAAAGCGGGTAATTGTTC
ATCAAATAGGTGGCATCTT -> TCAAATAGGTGGCATCTTG
ATCAAGGTAATGAAATTCA -> TCAAGGTAATGAAATTCAG
ATCAATTCGTGGCGGGTAC -> TCAATTCGTGGCGGGTACG
ATCAATTCGTTATTGCAAC -> TCAATTCGTTATTGCAACG
ATCACCTGAACAAACGTTA -> TCACCTGAACAAACGTTAT
ATCACGACTCAGGAGACAT -> TCACGACTCAGGAGACATC
ATCAGGCCAGTACTTGTAT -> TCAGGCCAGTACTTGTATA
ATCAGTCCGAAATTCATTT -> TCAGTCCGAAATTCATTTC
ATCATACAGCCATCGTGAA -> TCATACAGCCATCGTGAAA
ATCATAGATTAATACCATG -> TCATAGATTAATACCATGT
ATCATGGGTTTGCATGTTC -> TCATGGGTTTGCATGTTCA
ATCATTACCGTCAGGATCT -> TCATTACCGTCAGGATCTT
ATCCCGCTAGTGCGGGTCG -> TCCCGCTAGTGCGGGTCGA
ATCCCTTAGTAGCCCAGCT -> TCCCTTAGTAGCCCAGCTA
ATCCGAACCACCGTCAAGA -> TCCGAACCACCGTCAAGAG
ATCCGGACTCACTAAAATG -> TCCGGACTCACTAAAATGC
ATCCGGACTCCACAGCCTT -> TCCGGACTCCACAGCCTTG
ATCCGTACCCGAAAAAATT -> TCCGTACCCGAAAAAATTG
ATCCTCCACTAGAATCATA -> TCCTCCACTAGAATCATAG
ATCCTCTAAGGCAACGTGT -> TCCTCTAAGGCAACGTGTC
ATCCTTCTACAGTCACTGT -> TCCTTCTACAGTCACTGTA
ATCGAGGTAAAGCGGGCTT -> TCGAGGTAAAGCGGGCTTT
ATCGATATGAGGCTTTATT -> TCGATATGAGGCTTTATTA
ATCGCAATACCCACGGCAA -> TCGCAATACCCACGGCAAT
ATCGCAGAGTCTCTGAGGC -> TCGCAGAGTCTCTGAGGCC
ATCGGTTCAGCTTTAAGCT -> TCGGTTCAGCTTTAAGCTA
ATCGTGAAACTGATTTAAA -> TCGTGAAACTGATTTAAAA
ATCGTTAGCCGTTGCTCGC -> TCGTTAGCCGTTGCTCGCC
ATCTAAGAAGTGACCCTGG -> TCTAAGAAGTGACCCTGGA
ATCTACTTGGGGCACCTGA -> TCTACTTGGGGCACCTGAT
ATCTGTTACTAGGCATCGC -> TCTGTTACTAGGCATCGCA
ATCTTAATATATTTAAAGA -> TCTTAATATATTTAAAGAA
ATCTTATTCCCTGGGATTG -> TCTTATTCCCTGGGATTGA
ATCTTCATATTGTCGTCAC -> TCTTCATATTGTCGTCACG
ATCTTGATTTTCTAGGGTC -> TCTTGATTTTCTAGGGTCT
ATCTTTCCCTGCTGTGAGA -> TCTTTCCCTGCTGTGAGAA
ATCTTTCCCTGCTGTGAGC -> TCTTTCCCTGCTGTGAGCA
ATCTTTCCCTGCTGTGAGG -> TCTTTCCCTGCTGTGAGGT
ATCTTTCCCTGCTGTGAGT -> TCTTTCCCTGCTGTGAGTG
ATGAAACACGTCAATTCTT -> TGAAACACGTCAATTCTTG
ATGAAATTCAGGTTAATGG -> TGAAATTCAGGTTAATGGT
ATGAATGCACGGTAGACAG -> TGAATGCACGGTAGACAGG
ATGACGATCGAGGTAAAGC -> TGACGATCGAGGTAAAGCG
ATGACTCGACACCACTTGT -> TGACTCGACACCACTTGTC
ATGAGCCTCTTGGTTTGGA -> TGAGCCTCTTGGTTTGGAG
ATGAGGCTTTATTAGTATT -> TGAGGCTTTATTAGTATTG
ATGATAGTTAGGGGGCTGA -> TGATAGTTAGGGGGCTGAG
ATGATCTAAGAAGTGACCC -> TGATCTAAGAAGTGACCCT
ATGCAAAGAGGCAGTATCC -> TGCAAAGAGGCAGTATCCG
ATGCACGGTAGACAGGGTT -> TGCACGGTAGACAGGGTTT
ATGCCAACATACTAACGGT -> TGCCAACATACTAACGGTT
ATGCCGTGGGTGTCTGCAC -> TGCCGTGGGTGTCTGCACC
ATGCTGCTAAGCCCTGTCT -> TGCTGCTAAGCCCTGTCTG
ATGGAATCACGACTCAGGA -> TGGAATCACGACTCAGGAG
ATGGAGATCTTTCCCTGCT -> TGGAGATCTTTCCCTGCTG
ATGGCGCGCAAGGATTCTA -> TGGCGCGCAAGGATTCTAG
ATGGCGGATCCCTTAGTAG -> TGGCGGATCCCTTAGTAGC
ATGGCGGGGGACCCCGTTG -> TGGCGGGGGACCCCGTTGA
ATGGCGTCCAGCTAAAAAA -> TGGCGTCCAGCTAAAAAAG
ATGGGGTATCCTCTAAGGC -> TGGGGTATCCTCTAAGGCA
ATGGGTTTGCATGTTCATC -> TGGGTTTGCATGTTCATCG
ATGGTGCTTGAAGCCCATT -> TGGTGCTTGAAGCCCATTG
ATGGTTACCCGGACCCAGA -> TGGTTACCCGGACCCAGAT
ATGTAACGCTATAGGTTTC -> TGTAACGCTATAGGTTTCA
ATGTAATACATCTTATTCC -> TGTAATACATCTTATTCCC
ATGTGCTCAAACGACGTTG -> TGTGCTCAAACGACGTTGG
ATGTTCATCGATATGAGGC -> TGTTCATCGATATGAGGCT
ATGTTTAGTCCACCACATG -> TGTTTAGTCCACCACATGT
ATTAATACCATGTAACGCT -> TTAATACCATGTAACGCTA
ATTACAGACATGAGCCTCT -> TTACAGACATGAGCCTCTT
ATTACCGTCAGGATCTTAA -> TTACCGTCAGGATCTTAAT
ATTACGGTGAGAAGGGGAC -> TTACGGTGAGAAGGGGACT
ATTAGGGCAGCTATAACAT -> TTAGGGCAGCTATAACATG
ATTAGTATTGGTGAACAAT -> TTAGTATTGGTGAACAATA
ATTATATATGGCGTCCAGC -> TTATATATGGCGTCCAGCT
ATTATGCCGTGGGTGTCTG -> TTATGCCGTGGGTGTCTGC
ATTATTCATCATGGGTTTG -> TTATTCATCATGGGTTTGC
ATTCAGGTTAATGGTTACC -> TTCAGGTTAATGGTTACCC
ATTCATCATGGGTTTGCAT -> TTCATCATGGGTTTGCATG
ATTCATTTCAGAGCATAGC -> TTCATTTCAGAGCATAGCT
ATTCCCTGGGATTGATAAT -> TTCCCTGGGATTGATAATC
ATTCCGTAAGGATGAAACA -> TTCCGTAAGGATGAAACAC
ATTCGGCTCAGGGGCAGTT -> TTCGGCTCAGGGGCAGTTA
ATTCGTGGCGGGTACGAAC -> TTCGTGGCGGGTACGAACC
ATTCGTTATTGCAACGTGT -> TTCGTTATTGCAACGTGTA
ATTCTAGCCTACACGGGGC -> TTCTAGCCTACACGGGGCT
ATTCTTGCGCTTTTTGATG -> TTCTTGCGCTTTTTGATGT
ATTGACTGCGAAACGCAGT -> TTGACTGCGAAACGCAGTA
ATTGATAATCAATTCGTGG -> TTGATAATCAATTCGTGGC
ATTGCAACGTGTAAATTTG -> TTGCAACGTGTAAATTTGT
ATTGGCAAAGAGTTCGCCG -> TTGGCAAAGAGTTCGCCGT
ATTGGTGAACAATACCCAT -> TTGGTGAACAATACCCATT
ATTGGTTATATCAAAGCGG -> TTGGTTATATCAAAGCGGG
ATTGTCGTCACGTTAGTGG -> TTGTCGTCACGTTAGTGGC
ATTGTTCCTCTTAATCCCG -> TTGTTCCTCTTAATCCCGC
ATTTAAAAGCAGACACCGG -> TTTAAAAGCAGACACCGGG
ATTTAAAGAAGTTTATCGT -> TTTAAAGAAGTTTATCGTT
ATTTACGAACGACGAGAGT -> TTTACGAACGACGAGAGTT
ATTTATATTATGCCGTGGG -> TTTATATTATGCCGTGGGT
ATTTCAGAGCATAGCTACT -> TTTCAGAGCATAGCTACTA
ATTTCCCTCGTCCGAAGAG -> TTTCCCTCGTCCGAAGAGT
ATTTCGGCTCCCATGAATG -> TTTCGGCTCCCATGAATGC
ATTTCTGAAAGATCTTTCC -> TTTCTGAAAGATCTTTCCC
ATTTGTCTTATTTCGGCTC -> TTTGTCTTATTTCGGCTCC
ATTTGTGAACAACGCCGCC -> TTTGTGAACAACGCCGCCA
ATTTTCTAGGGTCTAGCAA -> TTTTCTAGGGTCTAGCAAT
CAAACGACGTTGGGAGGGC -> AAACGACGTTGGGAGGGCG
CAAACGTTATTATTCATCA -> AAACGTTATTATTCATCAT
CAAACTATACTACGCCTTT -> AAACTATACTACGCCTTTA
CAAAGAGGCAGTATCCGGA -> AAAGAGGCAGTATCCGGAC
CAAAGAGTTCGCCGTTTAA -> AAAGAGTTCGCCGTTTAAG
CAAAGCGGGTAATTGTTCC -> AAAGCGGGTAATTGTTCCT
CAAATAGGTGGCATCTTGA -> AAATAGGTGGCATCTTGAT
CAACAACATAGCCCGGTTA -> AACAACATAGCCCGGTTAC
CAACATACTAACGGTTTGG -> AACATACTAACGGTTTGGA
CAACATAGCCCGGTTACGT -> AACATAGCCCGGTTACGTA
CAACATCGGTTCAGCTTTA -> AACATCGGTTCAGCTTTAA
CAACCCTGCTCAGCATCCT -> AACCCTGCTCAGCATCCTC
CAACCGATCAAATAGGTGG -> AACCGATCAAATAGGTGGC
CAACGAAGCGAACGCTGTC -> AACGAAGCGAACGCTGTCA
CAACGCCGCCAGTCAACAA -> AACGCCGCCAGTCAACAAC
CAACGTGTAAATTTGTCTT -> AACGTGTAAATTTGTCTTA
CAACGTGTCAGCGCAACCC -> AACGTGTCAGCGCAACCCT
CAACTAAACGAGGCATCAA -> AACTAAACGAGGCATCAAT
CAAGAACGCATTCCGTAAG -> AAGAACGCATTCCGTAAGG
CAAGAGTTTAAAGATCCGT -> AAGAGTTTAAAGATCCGTA
CAAGCTAGCCCCTCTAGTG -> AAGCTAGCCCCTCTAGTGA
CAAGGATTCTAGCCTACAC -> AAGGATTCTAGCCTACACG
CAAGGTAATGAAATTCAGG -> AAGGTAATGAAATTCAGGT
CAATACCCACGGCAATTAG -> AATACCCACGGCAATTAGG
CAATACCCATTATATATGG -> AATACCCATTATATATGGC
CAATACTTCATTCGGCTCA -> AATACTTCATTCGGCTCAG
CAATAGACGACTCGATGCA -> AATAGACGACTCGATGCAA
CAATAGTAACTATAGCTCC -> AATAGTAACTATAGCTCCT
CAATATCAGTCCGAAATTC -> AATATCAGTCCGAAATTCA
CAATTAGGGCAGCTATAAC -> AATTAGGGCAGCTATAACA
CAATTCGTGGCGGGTACGA -> AATTCGTGGCGGGTACGAA
CAATTCGTTATTGCAACGT -> AATTCGTTATTGCAACGTG
CAATTCTTGCGCTTTTTGA -> AATTCTTGCGCTTTTTGAT
CACACTGAGGTGAAGATCT -> ACACTGAGGTGAAGATCTT
CACAGATAATCCGGACTCA -> ACAGATAATCCGGACTCAC
CACAGATCTTTCCCTGCTG -> ACAGATCTTTCCCTGCTGT
CACAGCCTTGGCATAAGGA -> ACAGCCTTGGCATAAGGAA
CACAGGCAGGTCTGATGAC -> ACAGGCAGGTCTGATGACG
CACATGTAATACATCTTAT -> ACATGTAATACATCTTATT
CACCACATGTAATACATCT -> ACCACATGTAATACATCTT
CACCACGCCGTCCCACAGA -> ACCACGCCGTCCCACAGAT
CACCACTTGTCTGTCGCAG -> ACCACTTGTCTGTCGCAGC
CACCATTTCTGAAAGATCT -> ACCATTTCTGAAAGATCTT
CACCCCTTGGAAATTTCCC -> ACCCCTTGGAAATTTCCCT
CACCGGGCTCAGTCTCAGA -> ACCGGGCTCAGTCTCAGAC
CACCGTCAAGAGTTTAAAG -> ACCGTCAAGAGTTTAAAGA
CACCTGAACAAACGTTATT -> ACCTGAACAAACGTTATTA
CACCTGATATGGAATCACG -> ACCTGATATGGAATCACGA
CACGACTCAGGAGACATCT -> ACGACTCAGGAGACATCTT
CACGAGACGTCACAGATCT -> ACGAGACGTCACAGATCTT
CACGCCGTCCCACAGATAA -> ACGCCGTCCCACAGATAAT
CACGGCAATTAGGGCAGCT -> ACGGCAATTAGGGCAGCTA
CACGGGGCTTTGACGTTGG -> ACGGGGCTTTGACGTTGGT
CACGGTAGACAGGGTTTGG -> ACGGTAGACAGGGTTTGGA
CACGTCAATTCTTGCGCTT -> ACGTCAATTCTTGCGCTTT
CACGTTAGTGGCGCTGTCC -> ACGTTAGTGGCGCTGTCCG
CACTAAAATGCTGCTAAGC -> ACTAAAATGCTGCTAAGCC
CACTAACACTTGTGCGTAT -> ACTAACACTTGTGCGTATT
CACTAGAATCATAGATTAA -> ACTAGAATCATAGATTAAT
CACTGAGGTGAAGATCTTT -> ACTGAGGTGAAGATCTTTC
CACTGCTCGATGGAGATCT -> ACTGCTCGATGGAGATCTT
CACTGGGAGTCTACGTCCG -> ACTGGGAGTCTACGTCCGG
CACTGTAACGCCGTATGGT -> ACTGTAACGCCGTATGGTG
CACTTGTCTGTCGCAGCGC -> ACTTGTCTGTCGCAGCGCC
CACTTGTGCGTATTACAGA -> ACTTGTGCGTATTACAGAC
CAGAAGCGTTCAACTAAAC -> AGAAGCGTTCAACTAAACG
CAGACACCGGGCTCAGTCT -> AGACACCGGGCTCAGTCTC
CAGACATGAGCCTCTTGGT -> AGACATGAGCCTCTTGGTT
CAGACTTGCCAACGAAGCG -> AGACTTGCCAACGAAGCGA
CAGAGCATAGCTACTATTT -> AGAGCATAGCTACTATTTG
CAGAGTCTCTGAGGCCTGG -> AGAGTCTCTGAGGCCTGGG
CAGATAATCCGGACTCACT -> AGATAATCCGGACTCACTA
CAGATCTTTCCCTGCTGTG -> AGATCTTTCCCTGCTGTGA
CAGATTTATATTATGCCGT -> AGATTTATATTATGCCGTG
CAGCAGCCTCTGCGAAGCG -> AGCAGCCTCTGCGAAGCGC
CAGCATCCTCCACTAGAAT -> AGCATCCTCCACTAGAATC
CAGCCAATATCAGTCCGAA -> AGCCAATATCAGTCCGAAA
CAGCCATCGTGAAACTGAT -> AGCCATCGTGAAACTGATT
CAGCCTCTGCGAAGCGCGC -> AGCCTCTGCGAAGCGCGCG
CAGCCTTGGCATAAGGAAA -> AGCCTTGGCATAAGGAAAT
CAGCGCAACCCTGCTCAGC -> AGCGCAACCCTGCTCAGCA
CAGCGCCGACGGATTACGG -> AGCGCCGACGGATTACGGT
CAGCGGGGTCCCAATAGTA -> AGCGGGGTCCCAATAGTAA
CAGCTAAAAAAGGCTTACT -> AGCTAAAAAAGGCTTACTG
CAGCTAAGGAAGCTCTTAT -> AGCTAAGGAAGCTCTTATC
CAGCTATAACATGGCGCGC -> AGCTATAACATGGCGCGCA
CAGCTGTACCTGTCGCAAC -> AGCTGTACCTGTCGCAACA
CAGCTTTAAGCTACTACCA -> AGCTTTAAGCTACTACCAA
CAGGAGACATCTTCATATT -> AGGAGACATCTTCATATTG
CAGGATCTTAATATATTTA -> AGGATCTTAATATATTTAA
CAGGCAGGTCTGATGACGA -> AGGCAGGTCTGATGACGAT
CAGGCCAGTACTTGTATAT -> AGGCCAGTACTTGTATATC
CAGGGATCTGTTACTAGGC -> AGGGATCTGTTACTAGGCA
CAGGGGCAGTTATGGCGGG -> AGGGGCAGTTATGGCGGGG
CAGGGTTTGGAGTTGCGAC -> AGGGTTTGGAGTTGCGACA
CAGGTCTGATGACGATCGA -> AGGTCTGATGACGATCGAG
CAGGTTAATGGTTACCCGG -> AGGTTAATGGTTACCCGGA
CAGTACTTGTATATCACCT -> AGTACTTGTATATCACCTG
CAGTAGAGACCACTAACAC -> AGTAGAGACCACTAACACT
CAGTATCCGGACTCCACAG -> AGTATCCGGACTCCACAGC
CAGTCAACAACATAGCCCG -> AGTCAACAACATAGCCCGG
CAGTCACTGTAACGCCGTA -> AGTCACTGTAACGCCGTAT
CAGTCCGAAATTCATTTCA -> AGTCCGAAATTCATTTCAG
CAGTCTCAGACTTGCCAAC -> AGTCTCAGACTTGCCAACG
CAGTTATGGCGGGGGACCC -> AGTTATGGCGGGGGACCCC
CATAAGGAAATACTCTTGT -> ATAAGGAAATACTCTTGTG
CATACAGCCATCGTGAAAC -> ATACAGCCATCGTGAAACT
CATACTAACGGTTTGGAGT -> ATACTAACGGTTTGGAGTT
CATAGATTAATACCATGTA -> ATAGATTAATACCATGTAA
CATAGCCCGGTTACGTACC -> ATAGCCCGGTTACGTACCC
CATAGCTACTATTTGTGAA -> ATAGCTACTATTTGTGAAC
CATATTGTCGTCACGTTAG -> ATATTGTCGTCACGTTAGT
CATCAAGGTAATGAAATTC -> ATCAAGGTAATGAAATTCA
CATCAATTCGTTATTGCAA -> ATCAATTCGTTATTGCAAC
CATCATGGGTTTGCATGTT -> ATCATGGGTTTGCATGTTC
CATCCTCCACTAGAATCAT -> ATCCTCCACTAGAATCATA
CATCCTTCTACAGTCACTG -> ATCCTTCTACAGTCACTGT
CATCGATATGAGGCTTTAT -> ATCGATATGAGGCTTTATT
CATCGCAATACCCACGGCA -> ATCGCAATACCCACGGCAA
CATCGCAGAGTCTCTGAGG -> ATCGCAGAGTCTCTGAGGC
CATCGGTTCAGCTTTAAGC -> ATCGGTTCAGCTTTAAGCT
CATCGTGAAACTGATTTAA -> ATCGTGAAACTGATTTAAA
CATCTTATTCCCTGGGATT -> ATCTTATTCCCTGGGATTG
CATCTTCATATTGTCGTCA -> ATCTTCATATTGTCGTCAC
CATCTTGATTTTCTAGGGT -> ATCTTGATTTTCTAGGGTC
CATGAATGCACGGTAGACA -> ATGAATGCACGGTAGACAG
CATGACTCGACACCACTTG -> ATGACTCGACACCACTTGT
CATGAGCCTCTTGGTTTGG -> ATGAGCCTCTTGGTTTGGA
CATGGCGCGCAAGGATTCT -> ATGGCGCGCAAGGATTCTA
CATGGGGTATCCTCTAAGG -> ATGGGGTATCCTCTAAGGC
CATGGGTTTGCATGTTCAT -> ATGGGTTTGCATGTTCATC
CATGTAACGCTATAGGTTT -> ATGTAACGCTATAGGTTTC
CATGTAATACATCTTATTC -> ATGTAATACATCTTATTCC
CATGTTCATCGATATGAGG -> ATGTTCATCGATATGAGGC
CATTACCGTCAGGATCTTA -> ATTACCGTCAGGATCTTAA
CATTATATATGGCGTCCAG -> ATTATATATGGCGTCCAGC
CATTCCGTAAGGATGAAAC -> ATTCCGTAAGGATGAAACA
CATTCGGCTCAGGGGCAGT -> ATTCGGCTCAGGGGCAGTT
CATTGACTGCGAAACGCAG -> ATTGACTGCGAAACGCAGT
CATTGGTTATATCAAAGCG -> ATTGGTTATATCAAAGCGG
CATTTCAGAGCATAGCTAC -> ATTTCAGAGCATAGCTACT
CATTTCTGAAAGATCTTTC -> ATTTCTGAAAGATCTTTCC
CCAACATACTAACGGTTTG -> CAACATACTAACGGTTTGG
CCAACGAAGCGAACGCTGT -> CAACGAAGCGAACGCTGTC
CCAATAGACGACTCGATGC -> CAATAGACGACTCGATGCA
CCAATAGTAACTATAGCTC -> CAATAGTAACTATAGCTCC
CCAATATCAGTCCGAAATT -> CAATATCAGTCCGAAATTC
CCACAGATAATCCGGACTC -> CACAGATAATCCGGACTCA
CCACAGCCTTGGCATAAGG -> CACAGCCTTGGCATAAGGA
CCACATGTAATACATCTTA -> CACATGTAATACATCTTAT
CCACCACATGTAATACATC -> CACCACATGTAATACATCT
CCACCGTCAAGAGTTTAAA -> CACCGTCAAGAGTTTAAAG
CCACGCCGTCCCACAGATA -> CACGCCGTCCCACAGATAA
CCACGGCAATTAGGGCAGC -> CACGGCAATTAGGGCAGCT
CCACTAACACTTGTGCGTA -> CACTAACACTTGTGCGTAT
CCACTAGAATCATAGATTA -> CACTAGAATCATAGATTAA
CCACTGGGAGTCTACGTCC -> CACTGGGAGTCTACGTCCG
CCACTTGTCTGTCGCAGCG -> CACTTGTCTGTCGCAGCGC
CCAGATTTATATTATGCCG -> CAGATTTATATTATGCCGT
CCAGCTAAAAAAGGCTTAC -> CAGCTAAAAAAGGCTTACT
CCAGCTAAGGAAGCTCTTA -> CAGCTAAGGAAGCTCTTAT
CCAGGGATCTGTTACTAGG -> CAGGGATCTGTTACTAGGC
CCAGTACTTGTATATCACC -> CAGTACTTGTATATCACCT
CCAGTCAACAACATAGCCC -> CAGTCAACAACATAGCCCG
CCATCGCAGAGTCTCTGAG -> CATCGCAGAGTCTCTGAGG
CCATCGTGAAACTGATTTA -> CATCGTGAAACTGATTTAA
CCATGAATGCACGGTAGAC -> CATGAATGCACGGTAGACA
CCATGTAACGCTATAGGTT -> CATGTAACGCTATAGGTTT
CCATTATATATGGCGTCCA -> CATTATATATGGCGTCCAG
CCATTGGTTATATCAAAGC -> CATTGGTTATATCAAAGCG
CCATTTCTGAAAGATCTTT -> CATTTCTGAAAGATCTTTC
CCCAATAGTAACTATAGCT -> CCAATAGTAACTATAGCTC
CCCACAGATAATCCGGACT -> CCACAGATAATCCGGACTC
CCCACGGCAATTAGGGCAG -> CCACGGCAATTAGGGCAGC
CCCAGATTTATATTATGCC -> CCAGATTTATATTATGCCG
CCCAGCTAAGGAAGCTCTT -> CCAGCTAAGGAAGCTCTTA
CCCATGAATGCACGGTAGA -> CCATGAATGCACGGTAGAC
CCCATTATATATGGCGTCC -> CCATTATATATGGCGTCCA
CCCATTGGTTATATCAAAG -> CCATTGGTTATATCAAAGC
CCCCGTTGAATGATCTAAG -> CCCGTTGAATGATCTAAGA
CCCCTCTAGTGAAATCTAC -> CCCTCTAGTGAAATCTACT
CCCCTTGGAAATTTCCCTC -> CCCTTGGAAATTTCCCTCG
CCCGAAAAAATTGGCAAAG -> CCGAAAAAATTGGCAAAGA
CCCGAATGGCGGATCCCTT -> CCGAATGGCGGATCCCTTA
CCCGAGGTTTGGAGTTGCG -> CCGAGGTTTGGAGTTGCGA
CCCGCTAGTGCGGGTCGAT -> CCGCTAGTGCGGGTCGATG
CCCGGACCCAGATTTATAT -> CCGGACCCAGATTTATATT
CCCGGTTACGTACCCGAAT -> CCGGTTACGTACCCGAATG
CCCGTTGAATGATCTAAGA -> CCGTTGAATGATCTAAGAA
CCCTCGTCCGAAGAGTGCG -> CCTCGTCCGAAGAGTGCGA
CCCTCTAGTGAAATCTACT -> CCTCTAGTGAAATCTACTT
CCCTGCTCAGCATCCTCCA -> CCTGCTCAGCATCCTCCAC
CCCTGCTGTGAGAACCACT -> CCTGCTGTGAGAACCACTG
CCCTGCTGTGAGCAGCAGC -> CCTGCTGTGAGCAGCAGCC
CCCTGCTGTGAGGTGCGCA -> CCTGCTGTGAGGTGCGCAG
CCCTGCTGTGAGTGACGTT -> CCTGCTGTGAGTGACGTTG
CCCTGGAATACGCCATCGC -> CCTGGAATACGCCATCGCA
CCCTGGGATTGATAATCAA -> CCTGGGATTGATAATCAAT
CCCTGTCTGGGGGACCAGG -> CCTGTCTGGGGGACCAGGG
CCCTTAGTAGCCCAGCTAA -> CCTTAGTAGCCCAGCTAAG
CCCTTGGAAATTTCCCTCG -> CCTTGGAAATTTCCCTCGT
CCGAAAAAATTGGCAAAGA -> CGAAAAAATTGGCAAAGAG
CCGAAATTCATTTCAGAGC -> CGAAATTCATTTCAGAGCA
CCGAACCACCGTCAAGAGT -> CGAACCACCGTCAAGAGTT
CCGAAGAGTGCGACTTATT -> CGAAGAGTGCGACTTATTT
CCGAATCATACAGCCATCG -> CGAATCATACAGCCATCGT
CCGAATGGCGGATCCCTTA -> CGAATGGCGGATCCCTTAG
CCGACGGATTACGGTGAGA -> CGACGGATTACGGTGAGAA
CCGAGGTTTGGAGTTGCGA -> CGAGGTTTGGAGTTGCGAC
CCGATCAAATAGGTGGCAT -> CGATCAAATAGGTGGCATC
CCGATGTTTAGTCCACCAC -> CGATGTTTAGTCCACCACA
CCGCCAGTCAACAACATAG -> CGCCAGTCAACAACATAGC
CCGCCTCAGAAGCGTTCAA -> CGCCTCAGAAGCGTTCAAC
CCGCTAGTGCGGGTCGATG -> CGCTAGTGCGGGTCGATGC
CCGGACCCAGATTTATATT -> CGGACCCAGATTTATATTA
CCGGACTCACTAAAATGCT -> CGGACTCACTAAAATGCTG
CCGGACTCCACAGCCTTGG -> CGGACTCCACAGCCTTGGC
CCGGGCTCAGTCTCAGACT -> CGGGCTCAGTCTCAGACTT
CCGGGGAACTTAGTATAAA -> CGGGGAACTTAGTATAAAA
CCGGTTACGTACCCGAATG -> CGGTTACGTACCCGAATGG
CCGTAAGGATGAAACACGT -> CGTAAGGATGAAACACGTC
CCGTACCCGAAAAAATTGG -> CGTACCCGAAAAAATTGGC
CCGTATGGTGCTTGAAGCC -> CGTATGGTGCTTGAAGCCC
CCGTCAAGAGTTTAAAGAT -> CGTCAAGAGTTTAAAGATC
CCGTCAGGATCTTAATATA -> CGTCAGGATCTTAATATAT
CCGTCCCACAGATAATCCG -> CGTCCCACAGATAATCCGG
CCGTGGGTGTCTGCACCAC -> CGTGGGTGTCTGCACCACG
CCGTTGAATGATCTAAGAA -> CGTTGAATGATCTAAGAAG
CCGTTGCTCGCCGCCTCAG -> CGTTGCTCGCCGCCTCAGA
CCGTTGGATCAGGCCAGTA -> CGTTGGATCAGGCCAGTAC
CCGTTTAAGCCGATGTTTA -> CGTTTAAGCCGATGTTTAG
CCTACACGGGGCTTTGACG -> CTACACGGGGCTTTGACGT
CCTCAGAAGCGTTCAACTA -> CTCAGAAGCGTTCAACTAA
CCTCCACTAGAATCATAGA -> CTCCACTAGAATCATAGAT
CCTCGTCCGAAGAGTGCGA -> CTCGTCCGAAGAGTGCGAC
CCTCTAAGGCAACGTGTCA -> CTCTAAGGCAACGTGTCAG
CCTCTAGTGAAATCTACTT -> CTCTAGTGAAATCTACTTG
CCTCTGCGAAGCGCGCGTG -> CTCTGCGAAGCGCGCGTGG
CCTCTTAATCCCGCTAGTG -> CTCTTAATCCCGCTAGTGC
CCTCTTGGTTTGGAGTTGC -> CTCTTGGTTTGGAGTTGCG
CCTGAACAAACGTTATTAT -> CTGAACAAACGTTATTATT
CCTGATATGGAATCACGAC -> CTGATATGGAATCACGACT
CCTGCTCAGCATCCTCCAC -> CTGCTCAGCATCCTCCACT
CCTGCTGTGAGAACCACTG -> CTGCTGTGAGAACCACTGG
CCTGCTGTGAGCAGCAGCC -> CTGCTGTGAGCAGCAGCCT
CCTGCTGTGAGGTGCGCAG -> CTGCTGTGAGGTGCGCAGC
CCTGCTGTGAGTGACGTTG -> CTGCTGTGAGTGACGTTGG
CCTGGAATACGCCATCGCA -> CTGGAATACGCCATCGCAG
CCTGGGATTGATAATCAAT -> CTGGGATTGATAATCAATT
CCTGGGGATGATAGTTAGG -> CTGGGGATGATAGTTAGGG
CCTGTCGCAACATCGGTTC -> CTGTCGCAACATCGGTTCA
CCTGTCTGGGGGACCAGGG -> CTGTCTGGGGGACCAGGGA
CCTTAGTAGCCCAGCTAAG -> CTTAGTAGCCCAGCTAAGG
CCTTCAAGAACGCATTCCG -> CTTCAAGAACGCATTCCGT
CCTTCATGACTCGACACCA -> CTTCATGACTCGACACCAC
CCTTCTACAGTCACTGTAA -> CTTCTACAGTCACTGTAAC
CCTTGGAAATTTCCCTCGT -> CTTGGAAATTTCCCTCGTC
CCTTGGCATAAGGAAATAC -> CTTGGCATAAGGAAATACT
CCTTTAGATCATTACCGTC -> CTTTAGATCATTACCGTCA
CGAAAAAATTGGCAAAGAG -> GAAAAAATTGGCAAAGAGT
CGAAACGCAGTAGAGACCA -> GAAACGCAGTAGAGACCAC
CGAAATTCATTTCAGAGCA -> GAAATTCATTTCAGAGCAT
CGAACCACCGTCAAGAGTT -> GAACCACCGTCAAGAGTTT
CGAACCTTCAAGAACGCAT -> GAACCTTCAAGAACGCATT
CGAACGACGAGAGTTGGGC -> GAACGACGAGAGTTGGGCG
CGAACGCTGTCAACCGATC -> GAACGCTGTCAACCGATCA
CGAAGAGTGCGACTTATTT -> GAAGAGTGCGACTTATTTA
CGAAGCGAACGCTGTCAAC -> GAAGCGAACGCTGTCAACC
CGAAGCGCGCGTGGATACA -> GAAGCGCGCGTGGATACAT
CGAATCATACAGCCATCGT -> GAATCATACAGCCATCGTG
CGAATGGCGGATCCCTTAG -> GAATGGCGGATCCCTTAGT
CGACACACTGAGGTGAAGA -> GACACACTGAGGTGAAGAT
CGACACCACTTGTCTGTCG -> GACACCACTTGTCTGTCGC
CGACACCATTTCTGAAAGA -> GACACCATTTCTGAAAGAT
CGACACGAGACGTCACAGA -> GACACGAGACGTCACAGAT
CGACACTGCTCGATGGAGA -> GACACTGCTCGATGGAGAT
CGACGAGAGTTGGGCGGTC -> GACGAGAGTTGGGCGGTCT
CGACGGATTACGGTGAGAA -> GACGGATTACGGTGAGAAG
CGACGTTGGGAGGGCGGTA -> GACGTTGGGAGGGCGGTAA
CGACTCAGGAGACATCTTC -> GACTCAGGAGACATCTTCA
CGACTCGATGCAAAGAGGC -> GACTCGATGCAAAGAGGCA
CGACTTATTTACGAACGAC -> GACTTATTTACGAACGACG
CGAGACGTCACAGATCTTT -> GAGACGTCACAGATCTTTC
CGAGAGTTGGGCGGTCTTG -> GAGAGTTGGGCGGTCTTGA
CGAGGCATCAATTCGTTAT -> GAGGCATCAATTCGTTATT
CGAGGTAAAGCGGGCTTTC -> GAGGTAAAGCGGGCTTTCT
CGAGGTTTGGAGTTGCGAC -> GAGGTTTGGAGTTGCGACA
CGATATGAGGCTTTATTAG -> GATATGAGGCTTTATTAGT
CGATCAAATAGGTGGCATC -> GATCAAATAGGTGGCATCT
CGATCGAGGTAAAGCGGGC -> GATCGAGGTAAAGCGGGCT
CGATGCAAAGAGGCAGTAT -> GATGCAAAGAGGCAGTATC
CGATGCCAACATACTAACG -> GATGCCAACATACTAACGG
CGATGGAGATCTTTCCCTG -> GATGGAGATCTTTCCCTGC
CGATGTTTAGTCCACCACA -> GATGTTTAGTCCACCACAT
CGCAACATCGGTTCAGCTT -> GCAACATCGGTTCAGCTTT
CGCAACCCTGCTCAGCATC -> GCAACCCTGCTCAGCATCC
CGCAAGGATTCTAGCCTAC -> GCAAGGATTCTAGCCTACA
CGCAATACCCACGGCAATT -> GCAATACCCACGGCAATTA
CGCAGAGTCTCTGAGGCCT -> GCAGAGTCTCTGAGGCCTG
CGCAGCCAATATCAGTCCG -> GCAGCCAATATCAGTCCGA
CGCAGCGCCGACGGATTAC -> GCAGCGCCGACGGATTACG
CGCAGTAGAGACCACTAAC -> GCAGTAGAGACCACTAACA
CGCATTCCGTAAGGATGAA -> GCATTCCGTAAGGATGAAA
CGCCAGTCAACAACATAGC -> GCCAGTCAACAACATAGCC
CGCCATCGCAGAGTCTCTG -> GCCATCGCAGAGTCTCTGA
CGCCGACGGATTACGGTGA -> GCCGACGGATTACGGTGAG
CGCCGCCAGTCAACAACAT -> GCCGCCAGTCAACAACATA
CGCCGCCTCAGAAGCGTTC -> GCCGCCTCAGAAGCGTTCA
CGCCGTATGGTGCTTGAAG -> GCCGTATGGTGCTTGAAGC
CGCCGTCCCACAGATAATC -> GCCGTCCCACAGATAATCC
CGCCGTTTAAGCCGATGTT -> GCCGTTTAAGCCGATGTTT
CGCCTCAGAAGCGTTCAAC -> GCCTCAGAAGCGTTCAACT
CGCCTTTAGATCATTACCG -> GCCTTTAGATCATTACCGT
CGCGCAAGGATTCTAGCCT -> GCGCAAGGATTCTAGCCTA
CGCGCGTGGATACATCAAG -> GCGCGTGGATACATCAAGG
CGCGCTACTTGGCATCCTT -> GCGCTACTTGGCATCCTTC
CGCGGACGCTGCAAGCTAG -> GCGGACGCTGCAAGCTAGC
CGCGTGGATACATCAAGGT -> GCGTGGATACATCAAGGTA
CGCTACTTGGCATCCTTCT -> GCTACTTGGCATCCTTCTA
CGCTAGTGCGGGTCGATGC -> GCTAGTGCGGGTCGATGCC
CGCTATAGGTTTCACAGGC -> GCTATAGGTTTCACAGGCA
CGCTGCAAGCTAGCCCCTC -> GCTGCAAGCTAGCCCCTCT
CGCTGTCAACCGATCAAAT -> GCTGTCAACCGATCAAATA
CGCTGTCCGTTGGATCAGG -> GCTGTCCGTTGGATCAGGC
CGCTTTTTGATGTGCTCAA -> GCTTTTTGATGTGCTCAAA
CGGACCCAGATTTATATTA -> GGACCCAGATTTATATTAT
CGGACGCTGCAAGCTAGCC -> GGACGCTGCAAGCTAGCCC
CGGACTCACTAAAATGCTG -> GGACTCACTAAAATGCTGC
CGGACTCCACAGCCTTGGC -> GGACTCCACAGCCTTGGCA
CGGATCCCTTAGTAGCCCA -> GGATCCCTTAGTAGCCCAG
CGGATTACGGTGAGAAGGG -> GGATTACGGTGAGAAGGGG
CGGCAATTAGGGCAGCTAT -> GGCAATTAGGGCAGCTATA
CGGCTCAGGGGCAGTTATG -> GGCTCAGGGGCAGTTATGG
CGGCTCCCATGAATGCACG -> GGCTCCCATGAATGCACGG
CGGGCTCAGTCTCAGACTT -> GGGCTCAGTCTCAGACTTG
CGGGCTTTCTACCGAATCA -> GGGCTTTCTACCGAATCAT
CGGGGAACTTAGTATAAAA -> GGGGAACTTAGTATAAAAC
CGGGGCTTTGACGTTGGTA -> GGGGCTTTGACGTTGGTAA
CGGGGGACCCCGTTGAATG -> GGGGGACCCCGTTGAATGA
CGGGGTCCCAATAGTAACT -> GGGGTCCCAATAGTAACTA
CGGGTAATTGTTCCTCTTA -> GGGTAATTGTTCCTCTTAA
CGGGTACGAACCTTCAAGA -> GGGTACGAACCTTCAAGAA
CGGGTCGATGCCAACATAC -> GGGTCGATGCCAACATACT
CGGTAACTCAGCGGGGTCC -> GGTAACTCAGCGGGGTCCC
CGGTAGACAGGGTTTGGAG -> GGTAGACAGGGTTTGGAGT
CGGTCTTGACGTTTCTCGC -> GGTCTTGACGTTTCTCGCG
CGGTGAGAAGGGGACTTGG -> GGTGAGAAGGGGACTTGGA
CGGTTACGTACCCGAATGG -> GGTTACGTACCCGAATGGC
CGGTTCAGCTTTAAGCTAC -> GGTTCAGCTTTAAGCTACT
CGGTTTGGAGTTGCGACAC -> GGTTTGGAGTTGCGACACC
CGTAAGGATGAAACACGTC -> GTAAGGATGAAACACGTCA
CGTACCCGAAAAAATTGGC -> GTACCCGAAAAAATTGGCA
CGTACCCGAATGGCGGATC -> GTACCCGAATGGCGGATCC
CGTATGGTGCTTGAAGCCC -> GTATGGTGCTTGAAGCCCA
CGTATTACAGACATGAGCC -> GTATTACAGACATGAGCCT
CGTCAAGAGTTTAAAGATC -> GTCAAGAGTTTAAAGATCC
CGTCAATTCTTGCGCTTTT -> GTCAATTCTTGCGCTTTTT
CGTCACAGATCTTTCCCTG -> GTCACAGATCTTTCCCTGC
CGTCACGTTAGTGGCGCTG -> GTCACGTTAGTGGCGCTGT
CGTCAGGATCTTAATATAT -> GTCAGGATCTTAATATATT
CGTCCAGCTAAAAAAGGCT -> GTCCAGCTAAAAAAGGCTT
CGTCCCACAGATAATCCGG -> GTCCCACAGATAATCCGGA
CGTCCGAAGAGTGCGACTT -> GTCCGAAGAGTGCGACTTA
CGTCCGGGGAACTTAGTAT -> GTCCGGGGAACTTAGTATA
CGTGAAACTGATTTAAAAG -> GTGAAACTGATTTAAAAGC
CGTGGATACATCAAGGTAA -> GTGGATACATCAAGGTAAT
CGTGGCGGGTACGAACCTT -> GTGGCGGGTACGAACCTTC
CGTGGGTGTCTGCACCACG -> GTGGGTGTCTGCACCACGC
CGTGTAAATTTGTCTTATT -> GTGTAAATTTGTCTTATTT
CGTGTCAGCGCAACCCTGC -> GTGTCAGCGCAACCCTGCT
CGTTAGCCGTTGCTCGCCG -> GTTAGCCGTTGCTCGCCGC
CGTTAGTGGCGCTGTCCGT -> GTTAGTGGCGCTGTCCGTT
CGTTATTATTCATCATGGG -> GTTATTATTCATCATGGGT
CGTTATTGCAACGTGTAAA -> GTTATTGCAACGTGTAAAT
CGTTCAACTAAACGAGGCA -> GTTCAACTAAACGAGGCAT
CGTTGAATGATCTAAGAAG -> GTTGAATGATCTAAGAAGT
CGTTGCTCGCCGCCTCAGA -> GTTGCTCGCCGCCTCAGAA
CGTTGGATCAGGCCAGTAC -> GTTGGATCAGGCCAGTACT
CGTTGGGAGGGCGGTAACT -> GTTGGGAGGGCGGTAACTC
CGTTGGTAAAGGATAGGTC -> GTTGGTAAAGGATAGGTCA
CGTTGGTCAGCTGTACCTG -> GTTGGTCAGCTGTACCTGT
CGTTTAAGCCGATGTTTAG -> GTTTAAGCCGATGTTTAGT
CGTTTCTCGCGGACGCTGC -> GTTTCTCGCGGACGCTGCA
CTAAAAAAGGCTTACTGCT -> TAAAAAAGGCTTACTGCTT
CTAAAATGCTGCTAAGCCC -> TAAAATGCTGCTAAGCCCT
CTAAACGAGGCATCAATTC -> TAAACGAGGCATCAATTCG
CTAACACTTGTGCGTATTA -> TAACACTTGTGCGTATTAC
CTAACGGTTTGGAGTTGCG -> TAACGGTTTGGAGTTGCGA
CTAAGAAGTGACCCTGGAA -> TAAGAAGTGACCCTGGAAT
CTAAGCCCTGTCTGGGGGA -> TAAGCCCTGTCTGGGGGAC
CTAAGGAAGCTCTTATCCG -> TAAGGAAGCTCTTATCCGA
CTAAGGCAACGTGTCAGCG -> TAAGGCAACGTGTCAGCGC
CTACACGGGGCTTTGACGT -> TACACGGGGCTTTGACGTT
CTACAGTCACTGTAACGCC -> TACAGTCACTGTAACGCCG
CTACCAATAGACGACTCGA -> TACCAATAGACGACTCGAT
CTACCGAATCATACAGCCA -> TACCGAATCATACAGCCAT
CTACGCCTTTAGATCATTA -> TACGCCTTTAGATCATTAC
CTACGTCCGGGGAACTTAG -> TACGTCCGGGGAACTTAGT
CTACTACCAATAGACGACT -> TACTACCAATAGACGACTC
CTACTATTTGTGAACAACG -> TACTATTTGTGAACAACGC
CTACTTGGCATCCTTCTAC -> TACTTGGCATCCTTCTACA
CTACTTGGGGCACCTGATA -> TACTTGGGGCACCTGATAT
CTAGAATCATAGATTAATA -> TAGAATCATAGATTAATAC
CTAGCAATACTTCATTCGG -> TAGCAATACTTCATTCGGC
CTAGCCCCTCTAGTGAAAT -> TAGCCCCTCTAGTGAAATC
CTAGCCTACACGGGGCTTT -> TAGCCTACACGGGGCTTTG
CTAGGCATCGCAATACCCA -> TAGGCATCGCAATACCCAC
CTAGGGTCTAGCAATACTT -> TAGGGTCTAGCAATACTTC
CTAGTGAAATCTACTTGGG -> TAGTGAAATCTACTTGGGG
CTAGTGCGGGTCGATGCCA -> TAGTGCGGGTCGATGCCAA
CTATAACATGGCGCGCAAG -> TATAACATGGCGCGCAAGG
CTATACTACGCCTTTAGAT -> TATACTACGCCTTTAGATC
CTATAGCTCCTTCATGACT -> TATAGCTCCTTCATGACTC
CTATAGGTTTCACAGGCAG -> TATAGGTTTCACAGGCAGG
CTATTTGTGAACAACGCCG -> TATTTGTGAACAACGCCGC
CTCAAACGACGTTGGGAGG -> TCAAACGACGTTGGGAGGG
CTCACTAAAATGCTGCTAA -> TCACTAAAATGCTGCTAAG
CTCAGAAGCGTTCAACTAA -> TCAGAAGCGTTCAACTAAA
CTCAGACTTGCCAACGAAG -> TCAGACTTGCCAACGAAGC
CTCAGCATCCTCCACTAGA -> TCAGCATCCTCCACTAGAA
CTCAGCGGGGTCCCAATAG -> TCAGCGGGGTCCCAATAGT
CTCAGGAGACATCTTCATA -> TCAGGAGACATCTTCATAT
CTCAGGGGCAGTTATGGCG -> TCAGGGGCAGTTATGGCGG
CTCAGTCTCAGACTTGCCA -> TCAGTCTCAGACTTGCCAA
CTCCACAGCCTTGGCATAA -> TCCACAGCCTTGGCATAAG
CTCCACTAGAATCATAGAT -> TCCACTAGAATCATAGATT
CTCCCATGAATGCACGGTA -> TCCCATGAATGCACGGTAG
CTCCTTCATGACTCGACAC -> TCCTTCATGACTCGACACC
CTCGACACCACTTGTCTGT -> TCGACACCACTTGTCTGTC
CTCGATGCAAAGAGGCAGT -> TCGATGCAAAGAGGCAGTA
CTCGATGGAGATCTTTCCC -> TCGATGGAGATCTTTCCCT
CTCGCCGCCTCAGAAGCGT -> TCGCCGCCTCAGAAGCGTT
CTCGCGGACGCTGCAAGCT -> TCGCGGACGCTGCAAGCTA
CTCGTCCGAAGAGTGCGAC -> TCGTCCGAAGAGTGCGACT
CTCTAAGGCAACGTGTCAG -> TCTAAGGCAACGTGTCAGC
CTCTAGTGAAATCTACTTG -> TCTAGTGAAATCTACTTGG
CTCTGAGGCCTGGGGATGA -> TCTGAGGCCTGGGGATGAT
CTCTGCGAAGCGCGCGTGG -> TCTGCGAAGCGCGCGTGGA
CTCTTAATCCCGCTAGTGC -> TCTTAATCCCGCTAGTGCG
CTCTTATCCGAACCACCGT -> TCTTATCCGAACCACCGTC
CTCTTGGTTTGGAGTTGCG -> TCTTGGTTTGGAGTTGCGA
CTCTTGTGCTGTGCTTCAT -> TCTTGTGCTGTGCTTCATT
CTGAAAGATCTTTCCCTGC -> TGAAAGATCTTTCCCTGCT
CTGAACAAACGTTATTATT -> TGAACAAACGTTATTATTC
CTGAGCAAACTATACTACG -> TGAGCAAACTATACTACGC
CTGAGCTGAGCAAACTATA -> TGAGCTGAGCAAACTATAC
CTGAGGCCTGGGGATGATA -> TGAGGCCTGGGGATGATAG
CTGAGGTGAAGATCTTTCC -> TGAGGTGAAGATCTTTCCC
CTGATATGGAATCACGACT -> TGATATGGAATCACGACTC
CTGATGACGATCGAGGTAA -> TGATGACGATCGAGGTAAA
CTGATTTAAAAGCAGACAC -> TGATTTAAAAGCAGACACC
CTGCAAGCTAGCCCCTCTA -> TGCAAGCTAGCCCCTCTAG
CTGCACCACGCCGTCCCAC -> TGCACCACGCCGTCCCACA
CTGCGAAACGCAGTAGAGA -> TGCGAAACGCAGTAGAGAC
CTGCGAAGCGCGCGTGGAT -> TGCGAAGCGCGCGTGGATA
CTGCTAAGCCCTGTCTGGG -> TGCTAAGCCCTGTCTGGGG
CTGCTCAGCATCCTCCACT -> TGCTCAGCATCCTCCACTA
CTGCTCGATGGAGATCTTT -> TGCTCGATGGAGATCTTTC
CTGCTGTGAGAACCACTGG -> TGCTGTGAGAACCACTGGG
CTGCTGTGAGCAGCAGCCT -> TGCTGTGAGCAGCAGCCTC
CTGCTGTGAGGTGCGCAGC -> TGCTGTGAGGTGCGCAGCC
CTGCTGTGAGTGACGTTGG -> TGCTGTGAGTGACGTTGGT
CTGGAATACGCCATCGCAG -> TGGAATACGCCATCGCAGA
CTGGGAGTCTACGTCCGGG -> TGGGAGTCTACGTCCGGGG
CTGGGATTGATAATCAATT -> TGGGATTGATAATCAATTC
CTGGGGATGATAGTTAGGG -> TGGGGATGATAGTTAGGGG
CTGGGGGACCAGGGATCTG -> TGGGGGACCAGGGATCTGT
CTGTAACGCCGTATGGTGC -> TGTAACGCCGTATGGTGCT
CTGTACCTGTCGCAACATC -> TGTACCTGTCGCAACATCG
CTGTCAACCGATCAAATAG -> TGTCAACCGATCAAATAGG
CTGTCCGTTGGATCAGGCC -> TGTCCGTTGGATCAGGCCA
CTGTCGCAACATCGGTTCA -> TGTCGCAACATCGGTTCAG
CTGTCGCAGCGCCGACGGA -> TGTCGCAGCGCCGACGGAT
CTGTCTGGGGGACCAGGGA -> TGTCTGGGGGACCAGGGAT
CTGTGAGAACCACTGGGAG -> TGTGAGAACCACTGGGAGT
CTGTGAGCAGCAGCCTCTG -> TGTGAGCAGCAGCCTCTGC
CTGTGAGGTGCGCAGCCAA -> TGTGAGGTGCGCAGCCAAT
CTGTGAGTGACGTTGGTCA -> TGTGAGTGACGTTGGTCAG
CTGTGCTTCATTGACTGCG -> TGTGCTTCATTGACTGCGA
CTGTTACTAGGCATCGCAA -> TGTTACTAGGCATCGCAAT
CTTAATATATTTAAAGAAG -> TTAATATATTTAAAGAAGT
CTTAATCCCGCTAGTGCGG -> TTAATCCCGCTAGTGCGGG
CTTAGTAGCCCAGCTAAGG -> TTAGTAGCCCAGCTAAGGA
CTTAGTATAAAACCCGAGG -> TTAGTATAAAACCCGAGGT
CTTATCCGAACCACCGTCA -> TTATCCGAACCACCGTCAA
CTTATTCCCTGGGATTGAT -> TTATTCCCTGGGATTGATA
CTTATTTACGAACGACGAG -> TTATTTACGAACGACGAGA
CTTATTTCGGCTCCCATGA -> TTATTTCGGCTCCCATGAA
CTTCAAGAACGCATTCCGT -> TTCAAGAACGCATTCCGTA
CTTCATATTGTCGTCACGT -> TTCATATTGTCGTCACGTT
CTTCATGACTCGACACCAC -> TTCATGACTCGACACCACT
CTTCATTCGGCTCAGGGGC -> TTCATTCGGCTCAGGGGCA
CTTCATTGACTGCGAAACG -> TTCATTGACTGCGAAACGC
CTTCTACAGTCACTGTAAC -> TTCTACAGTCACTGTAACG
CTTGAAGCCCATTGGTTAT -> TTGAAGCCCATTGGTTATA
CTTGACGTTTCTCGCGGAC -> TTGACGTTTCTCGCGGACG
CTTGATTTTCTAGGGTCTA -> TTGATTTTCTAGGGTCTAG
CTTGCCAACGAAGCGAACG -> TTGCCAACGAAGCGAACGC
CTTGCGCTTTTTGATGTGC -> TTGCGCTTTTTGATGTGCT
CTTGGAAAGGTAGTAGAAG -> TTGGAAAGGTAGTAGAAGA
CTTGGAAATTTCCCTCGTC -> TTGGAAATTTCCCTCGTCC
CTTGGCATAAGGAAATACT -> TTGGCATAAGGAAATACTC
CTTGGCATCCTTCTACAGT -> TTGGCATCCTTCTACAGTC
CTTGGGGCACCTGATATGG -> TTGGGGCACCTGATATGGA
CTTGGTTTGGAGTTGCGAC -> TTGGTTTGGAGTTGCGACA
CTTGTATATCACCTGAACA -> TTGTATATCACCTGAACAA
CTTGTCTGTCGCAGCGCCG -> TTGTCTGTCGCAGCGCCGA
CTTGTGCGTATTACAGACA -> TTGTGCGTATTACAGACAT
CTTGTGCTGTGCTTCATTG -> TTGTGCTGTGCTTCATTGA
CTTTAAGCTACTACCAATA -> TTTAAGCTACTACCAATAG
CTTTAGATCATTACCGTCA -> TTTAGATCATTACCGTCAG
CTTTATTAGTATTGGTGAA -> TTTATTAGTATTGGTGAAC
CTTTCCCTGCTGTGAGAAC -> TTTCCCTGCTGTGAGAACC
CTTTCCCTGCTGTGAGCAG -> TTTCCCTGCTGTGAGCAGC
CTTTCCCTGCTGTGAGGTG -> TTTCCCTGCTGTGAGGTGC
CTTTCCCTGCTGTGAGTGA -> TTTCCCTGCTGTGAGTGAC
CTTTCTACCGAATCATACA -> TTTCTACCGAATCATACAG
CTTTGACGTTGGTAAAGGA -> TTTGACGTTGGTAAAGGAT
CTTTTTGATGTGCTCAAAC -> TTTTTGATGTGCTCAAACG
GAAAAAATTGGCAAAGAGT -> AAAAAATTGGCAAAGAGTT
GAAACACGTCAATTCTTGC -> AAACACGTCAATTCTTGCG
GAAACGCAGTAGAGACCAC -> AAACGCAGTAGAGACCACT
GAAACTGATTTAAAAGCAG -> AAACTGATTTAAAAGCAGA
GAAAGATCTTTCCCTGCTG -> AAAGATCTTTCCCTGCTGT
GAAAGGTAGTAGAAGATAC -> AAAGGTAGTAGAAGATACA
GAAATACTCTTGTGCTGTG -> AAATACTCTTGTGCTGTGC
GAAATCTACTTGGGGCACC -> AAATCTACTTGGGGCACCT
GAAATTCAGGTTAATGGTT -> AAATTCAGGTTAATGGTTA
GAAATTCATTTCAGAGCAT -> AAATTCATTTCAGAGCATA
GAAATTTCCCTCGTCCGAA -> AAATTTCCCTCGTCCGAAG
GAACAAACGTTATTATTCA -> AACAAACGTTATTATTCAT
GAACAACGCCGCCAGTCAA -> AACAACGCCGCCAGTCAAC
GAACAATACCCATTATATA -> AACAATACCCATTATATAT
GAACCACCGTCAAGAGTTT -> AACCACCGTCAAGAGTTTA
GAACCACTGGGAGTCTACG -> AACCACTGGGAGTCTACGT
GAACCTTCAAGAACGCATT -> AACCTTCAAGAACGCATTC
GAACGACGAGAGTTGGGCG -> AACGACGAGAGTTGGGCGG
GAACGCATTCCGTAAGGAT -> AACGCATTCCGTAAGGATG
GAACGCTGTCAACCGATCA -> AACGCTGTCAACCGATCAA
GAACTTAGTATAAAACCCG -> AACTTAGTATAAAACCCGA
GAAGAGTGCGACTTATTTA -> AAGAGTGCGACTTATTTAC
GAAGATACATGGGGTATCC -> AAGATACATGGGGTATCCT
GAAGATCTTTCCCTGCTGT -> AAGATCTTTCCCTGCTGTG
GAAGCCCATTGGTTATATC -> AAGCCCATTGGTTATATCA
GAAGCGAACGCTGTCAACC -> AAGCGAACGCTGTCAACCG
GAAGCGCGCGTGGATACAT -> AAGCGCGCGTGGATACATC
GAAGCGCGCTACTTGGCAT -> AAGCGCGCTACTTGGCATC
GAAGCGTTCAACTAAACGA -> AAGCGTTCAACTAAACGAG
GAAGCTCTTATCCGAACCA -> AAGCTCTTATCCGAACCAC
GAAGGGGACTTGGAAAGGT -> AAGGGGACTTGGAAAGGTA
GAAGTGACCCTGGAATACG -> AAGTGACCCTGGAATACGC
GAAGTTTATCGTTAGCCGT -> AAGTTTATCGTTAGCCGTT
GAATACGCCATCGCAGAGT -> AATACGCCATCGCAGAGTC
GAATCACGACTCAGGAGAC -> AATCACGACTCAGGAGACA
GAATCATACAGCCATCGTG -> AATCATACAGCCATCGTGA
GAATCATAGATTAATACCA -> AATCATAGATTAATACCAT
GAATGATCTAAGAAGTGAC -> AATGATCTAAGAAGTGACC
GAATGCACGGTAGACAGGG -> AATGCACGGTAGACAGGGT
GAATGGCGGATCCCTTAGT -> AATGGCGGATCCCTTAGTA
GACACACTGAGGTGAAGAT -> ACACACTGAGGTGAAGATC
GACACCACTTGTCTGTCGC -> ACACCACTTGTCTGTCGCA
GACACCATTTCTGAAAGAT -> ACACCATTTCTGAAAGATC
GACACCGGGCTCAGTCTCA -> ACACCGGGCTCAGTCTCAG
GACACGAGACGTCACAGAT -> ACACGAGACGTCACAGATC
GACACTGCTCGATGGAGAT -> ACACTGCTCGATGGAGATC
GACAGGGTTTGGAGTTGCG -> ACAGGGTTTGGAGTTGCGA
GACATCTTCATATTGTCGT -> ACATCTTCATATTGTCGTC
GACATGAGCCTCTTGGTTT -> ACATGAGCCTCTTGGTTTG
GACCACTAACACTTGTGCG -> ACCACTAACACTTGTGCGT
GACCAGGGATCTGTTACTA -> ACCAGGGATCTGTTACTAG
GACCCAGATTTATATTATG -> ACCCAGATTTATATTATGC
GACCCCGTTGAATGATCTA -> ACCCCGTTGAATGATCTAA
GACCCTGGAATACGCCATC -> ACCCTGGAATACGCCATCG
GACGACTCGATGCAAAGAG -> ACGACTCGATGCAAAGAGG
GACGAGAGTTGGGCGGTCT -> ACGAGAGTTGGGCGGTCTT
GACGATCGAGGTAAAGCGG -> ACGATCGAGGTAAAGCGGG
GACGCTGCAAGCTAGCCCC -> ACGCTGCAAGCTAGCCCCT
GACGGATTACGGTGAGAAG -> ACGGATTACGGTGAGAAGG
GACGTCACAGATCTTTCCC -> ACGTCACAGATCTTTCCCT
GACGTTGGGAGGGCGGTAA -> ACGTTGGGAGGGCGGTAAC
GACGTTGGTAAAGGATAGG -> ACGTTGGTAAAGGATAGGT
GACGTTGGTCAGCTGTACC -> ACGTTGGTCAGCTGTACCT
GACGTTTCTCGCGGACGCT -> ACGTTTCTCGCGGACGCTG
GACTCACTAAAATGCTGCT -> ACTCACTAAAATGCTGCTA
GACTCAGGAGACATCTTCA -> ACTCAGGAGACATCTTCAT
GACTCCACAGCCTTGGCAT -> ACTCCACAGCCTTGGCATA
GACTCGACACCACTTGTCT -> ACTCGACACCACTTGTCTG
GACTCGATGCAAAGAGGCA -> ACTCGATGCAAAGAGGCAG
GACTGCGAAACGCAGTAGA -> ACTGCGAAACGCAGTAGAG
GACTTATTTACGAACGACG -> ACTTATTTACGAACGACGA
GACTTGCCAACGAAGCGAA -> ACTTGCCAACGAAGCGAAC
GACTTGGAAAGGTAGTAGA -> ACTTGGAAAGGTAGTAGAA
GAGAACCACTGGGAGTCTA -> AGAACCACTGGGAGTCTAC
GAGAAGGGGACTTGGAAAG -> AGAAGGGGACTTGGAAAGG
GAGACATCTTCATATTGTC -> AGACATCTTCATATTGTCG
GAGACCACTAACACTTGTG -> AGACCACTAACACTTGTGC
GAGACGTCACAGATCTTTC -> AGACGTCACAGATCTTTCC
GAGAGTTGGGCGGTCTTGA -> AGAGTTGGGCGGTCTTGAC
GAGATCTTTCCCTGCTGTG -> AGATCTTTCCCTGCTGTGA
GAGCAAACTATACTACGCC -> AGCAAACTATACTACGCCT
GAGCAGCAGCCTCTGCGAA -> AGCAGCAGCCTCTGCGAAG
GAGCATAGCTACTATTTGT -> AGCATAGCTACTATTTGTG
GAGCCTCTTGGTTTGGAGT -> AGCCTCTTGGTTTGGAGTT
GAGCTGAGCAAACTATACT -> AGCTGAGCAAACTATACTA
GAGGCAGTATCCGGACTCC -> AGGCAGTATCCGGACTCCA
GAGGCATCAATTCGTTATT -> AGGCATCAATTCGTTATTG
GAGGCCTGGGGATGATAGT -> AGGCCTGGGGATGATAGTT
GAGGCTTTATTAGTATTGG -> AGGCTTTATTAGTATTGGT
GAGGGCGGTAACTCAGCGG -> AGGGCGGTAACTCAGCGGG
GAGGTAAAGCGGGCTTTCT -> AGGTAAAGCGGGCTTTCTA
GAGGTGAAGATCTTTCCCT -> AGGTGAAGATCTTTCCCTG
GAGGTGCGCAGCCAATATC -> AGGTGCGCAGCCAATATCA
GAGGTTTGGAGTTGCGACA -> AGGTTTGGAGTTGCGACAC
GAGTCTACGTCCGGGGAAC -> AGTCTACGTCCGGGGAACT
GAGTCTCTGAGGCCTGGGG -> AGTCTCTGAGGCCTGGGGA
GAGTGACGTTGGTCAGCTG -> AGTGACGTTGGTCAGCTGT
GAGTGCGACTTATTTACGA -> AGTGCGACTTATTTACGAA
GAGTTCGCCGTTTAAGCCG -> AGTTCGCCGTTTAAGCCGA
GAGTTGCGACACACTGAGG -> AGTTGCGACACACTGAGGT
GAGTTGCGACACCATTTCT -> AGTTGCGACACCATTTCTG
GAGTTGCGACACGAGACGT -> AGTTGCGACACGAGACGTC
GAGTTGCGACACTGCTCGA -> AGTTGCGACACTGCTCGAT
GAGTTGGGCGGTCTTGACG -> AGTTGGGCGGTCTTGACGT
GAGTTTAAAGATCCGTACC -> AGTTTAAAGATCCGTACCC
GATAATCAATTCGTGGCGG -> ATAATCAATTCGTGGCGGG
GATAATCCGGACTCACTAA -> ATAATCCGGACTCACTAAA
GATACATCAAGGTAATGAA -> ATACATCAAGGTAATGAAA
GATACATGGGGTATCCTCT -> ATACATGGGGTATCCTCTA
GATAGGTCACCCCTTGGAA -> ATAGGTCACCCCTTGGAAA
GATAGTTAGGGGGCTGAGC -> ATAGTTAGGGGGCTGAGCT
GATATGAGGCTTTATTAGT -> ATATGAGGCTTTATTAGTA
GATATGGAATCACGACTCA -> ATATGGAATCACGACTCAG
GATCAAATAGGTGGCATCT -> ATCAAATAGGTGGCATCTT
GATCAGGCCAGTACTTGTA -> ATCAGGCCAGTACTTGTAT
GATCATTACCGTCAGGATC -> ATCATTACCGTCAGGATCT
GATCCCTTAGTAGCCCAGC -> ATCCCTTAGTAGCCCAGCT
GATCCGTACCCGAAAAAAT -> ATCCGTACCCGAAAAAATT
GATCGAGGTAAAGCGGGCT -> ATCGAGGTAAAGCGGGCTT
GATCTAAGAAGTGACCCTG -> ATCTAAGAAGTGACCCTGG
GATCTGTTACTAGGCATCG -> ATCTGTTACTAGGCATCGC
GATCTTAATATATTTAAAG -> ATCTTAATATATTTAAAGA
GATCTTTCCCTGCTGTGAG -> ATCTTTCCCTGCTGTGAGA,ATCTTTCCCTGCTGTGAGC,ATCTTTCCCTGCTGTGAGG,ATCTTTCCCTGCTGTGAGT
GATGAAACACGTCAATTCT -> ATGAAACACGTCAATTCTT
GATGACGATCGAGGTAAAG -> ATGACGATCGAGGTAAAGC
GATGATAGTTAGGGGGCTG -> ATGATAGTTAGGGGGCTGA
GATGCAAAGAGGCAGTATC -> ATGCAAAGAGGCAGTATCC
GATGCCAACATACTAACGG -> ATGCCAACATACTAACGGT
GATGGAGATCTTTCCCTGC -> ATGGAGATCTTTCCCTGCT
GATGTGCTCAAACGACGTT -> ATGTGCTCAAACGACGTTG
GATGTTTAGTCCACCACAT -> ATGTTTAGTCCACCACATG
GATTAATACCATGTAACGC -> ATTAATACCATGTAACGCT
GATTACGGTGAGAAGGGGA -> ATTACGGTGAGAAGGGGAC
GATTCTAGCCTACACGGGG -> ATTCTAGCCTACACGGGGC
GATTGATAATCAATTCGTG -> ATTGATAATCAATTCGTGG
GATTTAAAAGCAGACACCG -> ATTTAAAAGCAGACACCGG
GATTTATATTATGCCGTGG -> ATTTATATTATGCCGTGGG
GATTTTCTAGGGTCTAGCA -> ATTTTCTAGGGTCTAGCAA
GCAAACTATACTACGCCTT -> CAAACTATACTACGCCTTT
GCAAAGAGGCAGTATCCGG -> CAAAGAGGCAGTATCCGGA
GCAAAGAGTTCGCCGTTTA -> CAAAGAGTTCGCCGTTTAA
GCAACATCGGTTCAGCTTT -> CAACATCGGTTCAGCTTTA
GCAACCCTGCTCAGCATCC -> CAACCCTGCTCAGCATCCT
GCAACGTGTAAATTTGTCT -> CAACGTGTAAATTTGTCTT
GCAACGTGTCAGCGCAACC -> CAACGTGTCAGCGCAACCC
GCAAGCTAGCCCCTCTAGT -> CAAGCTAGCCCCTCTAGTG
GCAAGGATTCTAGCCTACA -> CAAGGATTCTAGCCTACAC
GCAATACCCACGGCAATTA -> CAATACCCACGGCAATTAG
GCAATACTTCATTCGGCTC -> CAATACTTCATTCGGCTCA
GCAATTAGGGCAGCTATAA -> CAATTAGGGCAGCTATAAC
GCACCACGCCGTCCCACAG -> CACCACGCCGTCCCACAGA
GCACCTGATATGGAATCAC -> CACCTGATATGGAATCACG
GCACGGTAGACAGGGTTTG -> CACGGTAGACAGGGTTTGG
GCAGACACCGGGCTCAGTC -> CAGACACCGGGCTCAGTCT
GCAGAGTCTCTGAGGCCTG -> CAGAGTCTCTGAGGCCTGG
GCAGCAGCCTCTGCGAAGC -> CAGCAGCCTCTGCGAAGCG
GCAGCCAATATCAGTCCGA -> CAGCCAATATCAGTCCGAA
GCAGCCTCTGCGAAGCGCG -> CAGCCTCTGCGAAGCGCGC
GCAGCGCCGACGGATTACG -> CAGCGCCGACGGATTACGG
GCAGCTATAACATGGCGCG -> CAGCTATAACATGGCGCGC
GCAGGTCTGATGACGATCG -> CAGGTCTGATGACGATCGA
GCAGTAGAGACCACTAACA -> CAGTAGAGACCACTAACAC
GCAGTATCCGGACTCCACA -> CAGTATCCGGACTCCACAG
GCAGTTATGGCGGGGGACC -> CAGTTATGGCGGGGGACCC
GCATAAGGAAATACTCTTG -> CATAAGGAAATACTCTTGT
GCATAGCTACTATTTGTGA -> CATAGCTACTATTTGTGAA
GCATCAATTCGTTATTGCA -> CATCAATTCGTTATTGCAA
GCATCCTCCACTAGAATCA -> CATCCTCCACTAGAATCAT
GCATCCTTCTACAGTCACT -> CATCCTTCTACAGTCACTG
GCATCGCAATACCCACGGC -> CATCGCAATACCCACGGCA
GCATCTTGATTTTCTAGGG -> CATCTTGATTTTCTAGGGT
GCATGTTCATCGATATGAG -> CATGTTCATCGATATGAGG
GCATTCCGTAAGGATGAAA -> CATTCCGTAAGGATGAAAC
GCCAACATACTAACGGTTT -> CCAACATACTAACGGTTTG
GCCAACGAAGCGAACGCTG -> CCAACGAAGCGAACGCTGT
GCCAATATCAGTCCGAAAT -> CCAATATCAGTCCGAAATT
GCCAGTACTTGTATATCAC -> CCAGTACTTGTATATCACC
GCCAGTCAACAACATAGCC -> CCAGTCAACAACATAGCCC
GCCATCGCAGAGTCTCTGA -> CCATCGCAGAGTCTCTGAG
GCCATCGTGAAACTGATTT -> CCATCGTGAAACTGATTTA
GCCCAGCTAAGGAAGCTCT -> CCCAGCTAAGGAAGCTCTT
GCCCATTGGTTATATCAAA -> CCCATTGGTTATATCAAAG
GCCCCTCTAGTGAAATCTA -> CCCCTCTAGTGAAATCTAC
GCCCGGTTACGTACCCGAA -> CCCGGTTACGTACCCGAAT
GCCCTGTCTGGGGGACCAG -> CCCTGTCTGGGGGACCAGG
GCCGACGGATTACGGTGAG -> CCGACGGATTACGGTGAGA
GCCGATGTTTAGTCCACCA -> CCGATGTTTAGTCCACCAC
GCCGCCAGTCAACAACATA -> CCGCCAGTCAACAACATAG
GCCGCCTCAGAAGCGTTCA -> CCGCCTCAGAAGCGTTCAA
GCCGTATGGTGCTTGAAGC -> CCGTATGGTGCTTGAAGCC
GCCGTCCCACAGATAATCC -> CCGTCCCACAGATAATCCG
GCCGTGGGTGTCTGCACCA -> CCGTGGGTGTCTGCACCAC
GCCGTTGCTCGCCGCCTCA -> CCGTTGCTCGCCGCCTCAG
GCCGTTTAAGCCGATGTTT -> CCGTTTAAGCCGATGTTTA
GCCTACACGGGGCTTTGAC -> CCTACACGGGGCTTTGACG
GCCTCAGAAGCGTTCAACT -> CCTCAGAAGCGTTCAACTA
GCCTCTGCGAAGCGCGCGT -> CCTCTGCGAAGCGCGCGTG
GCCTCTTGGTTTGGAGTTG -> CCTCTTGGTTTGGAGTTGC
GCCTGGGGATGATAGTTAG -> CCTGGGGATGATAGTTAGG
GCCTTGGCATAAGGAAATA -> CCTTGGCATAAGGAAATAC
GCCTTTAGATCATTACCGT -> CCTTTAGATCATTACCGTC
GCGAAACGCAGTAGAGACC -> CGAAACGCAGTAGAGACCA
GCGAACGCTGTCAACCGAT -> CGAACGCTGTCAACCGATC
GCGAAGCGCGCGTGGATAC -> CGAAGCGCGCGTGGATACA
GCGACACACTGAGGTGAAG -> CGACACACTGAGGTGAAGA
GCGACACCATTTCTGAAAG -> CGACACCATTTCTGAAAGA
GCGACACGAGACGTCACAG -> CGACACGAGACGTCACAGA
GCGACACTGCTCGATGGAG -> CGACACTGCTCGATGGAGA
GCGACTTATTTACGAACGA -> CGACTTATTTACGAACGAC
GCGCAACCCTGCTCAGCAT -> CGCAACCCTGCTCAGCATC
GCGCAAGGATTCTAGCCTA -> CGCAAGGATTCTAGCCTAC
GCGCAGCCAATATCAGTCC -> CGCAGCCAATATCAGTCCG
GCGCCGACGGATTACGGTG -> CGCCGACGGATTACGGTGA
GCGCGCAAGGATTCTAGCC -> CGCGCAAGGATTCTAGCCT
GCGCGCGTGGATACATCAA -> CGCGCGTGGATACATCAAG
GCGCGCTACTTGGCATCCT -> CGCGCTACTTGGCATCCTT
GCGCGTGGATACATCAAGG -> CGCGTGGATACATCAAGGT
GCGCTACTTGGCATCCTTC -> CGCTACTTGGCATCCTTCT
GCGCTGTCCGTTGGATCAG -> CGCTGTCCGTTGGATCAGG
GCGCTTTTTGATGTGCTCA -> CGCTTTTTGATGTGCTCAA
GCGGACGCTGCAAGCTAGC -> CGGACGCTGCAAGCTAGCC
GCGGATCCCTTAGTAGCCC -> CGGATCCCTTAGTAGCCCA
GCGGGCTTTCTACCGAATC -> CGGGCTTTCTACCGAATCA
GCGGGGGACCCCGTTGAAT -> CGGGGGACCCCGTTGAATG
GCGGGGTCCCAATAGTAAC -> CGGGGTCCCAATAGTAACT
GCGGGTAATTGTTCCTCTT -> CGGGTAATTGTTCCTCTTA
GCGGGTACGAACCTTCAAG -> CGGGTACGAACCTTCAAGA
GCGGGTCGATGCCAACATA -> CGGGTCGATGCCAACATAC
GCGGTAACTCAGCGGGGTC -> CGGTAACTCAGCGGGGTCC
GCGGTCTTGACGTTTCTCG -> CGGTCTTGACGTTTCTCGC
GCGTATTACAGACATGAGC -> CGTATTACAGACATGAGCC
GCGTCCAGCTAAAAAAGGC -> CGTCCAGCTAAAAAAGGCT
GCGTGGATACATCAAGGTA -> CGTGGATACATCAAGGTAA
GCGTTCAACTAAACGAGGC -> CGTTCAACTAAACGAGGCA
GCTAAAAAAGGCTTACTGC -> CTAAAAAAGGCTTACTGCT
GCTAAGCCCTGTCTGGGGG -> CTAAGCCCTGTCTGGGGGA
GCTAAGGAAGCTCTTATCC -> CTAAGGAAGCTCTTATCCG
GCTACTACCAATAGACGAC -> CTACTACCAATAGACGACT
GCTACTATTTGTGAACAAC -> CTACTATTTGTGAACAACG
GCTACTTGGCATCCTTCTA -> CTACTTGGCATCCTTCTAC
GCTAGCCCCTCTAGTGAAA -> CTAGCCCCTCTAGTGAAAT
GCTAGTGCGGGTCGATGCC -> CTAGTGCGGGTCGATGCCA
GCTATAACATGGCGCGCAA -> CTATAACATGGCGCGCAAG
GCTATAGGTTTCACAGGCA -> CTATAGGTTTCACAGGCAG
GCTCAAACGACGTTGGGAG -> CTCAAACGACGTTGGGAGG
GCTCAGCATCCTCCACTAG -> CTCAGCATCCTCCACTAGA
GCTCAGGGGCAGTTATGGC -> CTCAGGGGCAGTTATGGCG
GCTCAGTCTCAGACTTGCC -> CTCAGTCTCAGACTTGCCA
GCTCCCATGAATGCACGGT -> CTCCCATGAATGCACGGTA
GCTCCTTCATGACTCGACA -> CTCCTTCATGACTCGACAC
GCTCGATGGAGATCTTTCC -> CTCGATGGAGATCTTTCCC
GCTCGCCGCCTCAGAAGCG -> CTCGCCGCCTCAGAAGCGT
GCTCTTATCCGAACCACCG -> CTCTTATCCGAACCACCGT
GCTGAGCAAACTATACTAC -> CTGAGCAAACTATACTACG
GCTGAGCTGAGCAAACTAT -> CTGAGCTGAGCAAACTATA
GCTGCAAGCTAGCCCCTCT -> CTGCAAGCTAGCCCCTCTA
GCTGCTAAGCCCTGTCTGG -> CTGCTAAGCCCTGTCTGGG
GCTGTACCTGTCGCAACAT -> CTGTACCTGTCGCAACATC
GCTGTCAACCGATCAAATA -> CTGTCAACCGATCAAATAG
GCTGTCCGTTGGATCAGGC -> CTGTCCGTTGGATCAGGCC
GCTGTGAGAACCACTGGGA -> CTGTGAGAACCACTGGGAG
GCTGTGAGCAGCAGCCTCT -> CTGTGAGCAGCAGCCTCTG
GCTGTGAGGTGCGCAGCCA -> CTGTGAGGTGCGCAGCCAA
GCTGTGAGTGACGTTGGTC -> CTGTGAGTGACGTTGGTCA
GCTGTGCTTCATTGACTGC -> CTGTGCTTCATTGACTGCG
GCTTCATTGACTGCGAAAC -> CTTCATTGACTGCGAAACG
GCTTGAAGCCCATTGGTTA -> CTTGAAGCCCATTGGTTAT
GCTTTAAGCTACTACCAAT -> CTTTAAGCTACTACCAATA
GCTTTATTAGTATTGGTGA -> CTTTATTAGTATTGGTGAA
GCTTTCTACCGAATCATAC -> CTTTCTACCGAATCATACA
GCTTTGACGTTGGTAAAGG -> CTTTGACGTTGGTAAAGGA
GCTTTTTGATGTGCTCAAA -> CTTTTTGATGTGCTCAAAC
GGAAAGGTAGTAGAAGATA -> GAAAGGTAGTAGAAGATAC
GGAAATACTCTTGTGCTGT -> GAAATACTCTTGTGCTGTG
GGAAATTTCCCTCGTCCGA -> GAAATTTCCCTCGTCCGAA
GGAACTTAGTATAAAACCC -> GAACTTAGTATAAAACCCG
GGAAGCTCTTATCCGAACC -> GAAGCTCTTATCCGAACCA
GGAATACGCCATCGCAGAG -> GAATACGCCATCGCAGAGT
GGAATCACGACTCAGGAGA -> GAATCACGACTCAGGAGAC
GGACCAGGGATCTGTTACT -> GACCAGGGATCTGTTACTA
GGACCCAGATTTATATTAT -> GACCCAGATTTATATTATG
GGACCCCGTTGAATGATCT -> GACCCCGTTGAATGATCTA
GGACGCTGCAAGCTAGCCC -> GACGCTGCAAGCTAGCCCC
GGACTCACTAAAATGCTGC -> GACTCACTAAAATGCTGCT
GGACTCCACAGCCTTGGCA -> GACTCCACAGCCTTGGCAT
GGACTTGGAAAGGTAGTAG -> GACTTGGAAAGGTAGTAGA
GGAGACATCTTCATATTGT -> GAGACATCTTCATATTGTC
GGAGATCTTTCCCTGCTGT -> GAGATCTTTCCCTGCTGTG
GGAGGGCGGTAACTCAGCG -> GAGGGCGGTAACTCAGCGG
GGAGTCTACGTCCGGGGAA -> GAGTCTACGTCCGGGGAAC
GGAGTTGCGACACACTGAG -> GAGTTGCGACACACTGAGG
GGAGTTGCGACACCATTTC -> GAGTTGCGACACCATTTCT
GGAGTTGCGACACGAGACG -> GAGTTGCGACACGAGACGT
GGAGTTGCGACACTGCTCG -> GAGTTGCGACACTGCTCGA
GGATACATCAAGGTAATGA -> GATACATCAAGGTAATGAA
GGATAGGTCACCCCTTGGA -> GATAGGTCACCCCTTGGAA
GGATCAGGCCAGTACTTGT -> GATCAGGCCAGTACTTGTA
GGATCCCTTAGTAGCCCAG -> GATCCCTTAGTAGCCCAGC
GGATCTGTTACTAGGCATC -> GATCTGTTACTAGGCATCG
GGATCTTAATATATTTAAA -> GATCTTAATATATTTAAAG
GGATGAAACACGTCAATTC -> GATGAAACACGTCAATTCT
GGATGATAGTTAGGGGGCT -> GATGATAGTTAGGGGGCTG
GGATTACGGTGAGAAGGGG -> GATTACGGTGAGAAGGGGA
GGATTCTAGCCTACACGGG -> GATTCTAGCCTACACGGGG
GGATTGATAATCAATTCGT -> GATTGATAATCAATTCGTG
GGCAAAGAGTTCGCCGTTT -> GCAAAGAGTTCGCCGTTTA
GGCAACGTGTCAGCGCAAC -> GCAACGTGTCAGCGCAACC
GGCAATTAGGGCAGCTATA -> GCAATTAGGGCAGCTATAA
GGCACCTGATATGGAATCA -> GCACCTGATATGGAATCAC
GGCAGCTATAACATGGCGC -> GCAGCTATAACATGGCGCG
GGCAGGTCTGATGACGATC -> GCAGGTCTGATGACGATCG
GGCAGTATCCGGACTCCAC -> GCAGTATCCGGACTCCACA
GGCAGTTATGGCGGGGGAC -> GCAGTTATGGCGGGGGACC
GGCATAAGGAAATACTCTT -> GCATAAGGAAATACTCTTG
GGCATCAATTCGTTATTGC -> GCATCAATTCGTTATTGCA
GGCATCCTTCTACAGTCAC -> GCATCCTTCTACAGTCACT
GGCATCGCAATACCCACGG -> GCATCGCAATACCCACGGC
GGCATCTTGATTTTCTAGG -> GCATCTTGATTTTCTAGGG
GGCCAGTACTTGTATATCA -> GCCAGTACTTGTATATCAC
GGCCTGGGGATGATAGTTA -> GCCTGGGGATGATAGTTAG
GGCGCGCAAGGATTCTAGC -> GCGCGCAAGGATTCTAGCC
GGCGCTGTCCGTTGGATCA -> GCGCTGTCCGTTGGATCAG
GGCGGATCCCTTAGTAGCC -> GCGGATCCCTTAGTAGCCC
GGCGGGGGACCCCGTTGAA -> GCGGGGGACCCCGTTGAAT
GGCGGGTACGAACCTTCAA -> GCGGGTACGAACCTTCAAG
GGCGGTAACTCAGCGGGGT -> GCGGTAACTCAGCGGGGTC
GGCGGTCTTGACGTTTCTC -> GCGGTCTTGACGTTTCTCG
GGCGTCCAGCTAAAAAAGG -> GCGTCCAGCTAAAAAAGGC
GGCTCAGGGGCAGTTATGG -> GCTCAGGGGCAGTTATGGC
GGCTCAGTCTCAGACTTGC -> GCTCAGTCTCAGACTTGCC
GGCTCCCATGAATGCACGG -> GCTCCCATGAATGCACGGT
GGCTGAGCTGAGCAAACTA -> GCTGAGCTGAGCAAACTAT
GGCTTTATTAGTATTGGTG -> GCTTTATTAGTATTGGTGA
GGCTTTCTACCGAATCATA -> GCTTTCTACCGAATCATAC
GGCTTTGACGTTGGTAAAG -> GCTTTGACGTTGGTAAAGG
GGGAACTTAGTATAAAACC -> GGAACTTAGTATAAAACCC
GGGACCAGGGATCTGTTAC -> GGACCAGGGATCTGTTACT
GGGACCCCGTTGAATGATC -> GGACCCCGTTGAATGATCT
GGGACTTGGAAAGGTAGTA -> GGACTTGGAAAGGTAGTAG
GGGAGGGCGGTAACTCAGC -> GGAGGGCGGTAACTCAGCG
GGGAGTCTACGTCCGGGGA -> GGAGTCTACGTCCGGGGAA
GGGATCTGTTACTAGGCAT -> GGATCTGTTACTAGGCATC
GGGATGATAGTTAGGGGGC -> GGATGATAGTTAGGGGGCT
GGGATTGATAATCAATTCG -> GGATTGATAATCAATTCGT
GGGCACCTGATATGGAATC -> GGCACCTGATATGGAATCA
GGGCAGCTATAACATGGCG -> GGCAGCTATAACATGGCGC
GGGCAGTTATGGCGGGGGA -> GGCAGTTATGGCGGGGGAC
GGGCGGTAACTCAGCGGGG -> GGCGGTAACTCAGCGGGGT
GGGCGGTCTTGACGTTTCT -> GGCGGTCTTGACGTTTCTC
GGGCTCAGTCTCAGACTTG -> GGCTCAGTCTCAGACTTGC
GGGCTGAGCTGAGCAAACT -> GGCTGAGCTGAGCAAACTA
GGGCTTTCTACCGAATCAT -> GGCTTTCTACCGAATCATA
GGGCTTTGACGTTGGTAAA -> GGCTTTGACGTTGGTAAAG
GGGGAACTTAGTATAAAAC -> GGGAACTTAGTATAAAACC
GGGGACCAGGGATCTGTTA -> GGGACCAGGGATCTGTTAC
GGGGACCCCGTTGAATGAT -> GGGACCCCGTTGAATGATC
GGGGACTTGGAAAGGTAGT -> GGGACTTGGAAAGGTAGTA
GGGGATGATAGTTAGGGGG -> GGGATGATAGTTAGGGGGC
GGGGCACCTGATATGGAAT -> GGGCACCTGATATGGAATC
GGGGCAGTTATGGCGGGGG -> GGGCAGTTATGGCGGGGGA
GGGGCTGAGCTGAGCAAAC -> GGGCTGAGCTGAGCAAACT
GGGGCTTTGACGTTGGTAA -> GGGCTTTGACGTTGGTAAA
GGGGGACCAGGGATCTGTT -> GGGGACCAGGGATCTGTTA
GGGGGACCCCGTTGAATGA -> GGGGACCCCGTTGAATGAT
GGGGGCTGAGCTGAGCAAA -> GGGGCTGAGCTGAGCAAAC
GGGGTATCCTCTAAGGCAA -> GGGTATCCTCTAAGGCAAC
GGGGTCCCAATAGTAACTA -> GGGTCCCAATAGTAACTAT
GGGTAATTGTTCCTCTTAA -> GGTAATTGTTCCTCTTAAT
GGGTACGAACCTTCAAGAA -> GGTACGAACCTTCAAGAAC
GGGTATCCTCTAAGGCAAC -> GGTATCCTCTAAGGCAACG
GGGTCCCAATAGTAACTAT -> GGTCCCAATAGTAACTATA
GGGTCGATGCCAACATACT -> GGTCGATGCCAACATACTA
GGGTCTAGCAATACTTCAT -> GGTCTAGCAATACTTCATT
GGGTGTCTGCACCACGCCG -> GGTGTCTGCACCACGCCGT
GGGTTTGCATGTTCATCGA -> GGTTTGCATGTTCATCGAT
GGGTTTGGAGTTGCGACAC -> GGTTTGGAGTTGCGACACG
GGTAAAGCGGGCTTTCTAC -> GTAAAGCGGGCTTTCTACC
GGTAAAGGATAGGTCACCC -> GTAAAGGATAGGTCACCCC
GGTAACTCAGCGGGGTCCC -> GTAACTCAGCGGGGTCCCA
GGTAATGAAATTCAGGTTA -> GTAATGAAATTCAGGTTAA
GGTAATTGTTCCTCTTAAT -> GTAATTGTTCCTCTTAATC
GGTACGAACCTTCAAGAAC -> GTACGAACCTTCAAGAACG
GGTAGACAGGGTTTGGAGT -> GTAGACAGGGTTTGGAGTT
GGTAGTAGAAGATACATGG -> GTAGTAGAAGATACATGGG
GGTATCCTCTAAGGCAACG -> GTATCCTCTAAGGCAACGT
GGTCACCCCTTGGAAATTT -> GTCACCCCTTGGAAATTTC
GGTCAGCTGTACCTGTCGC -> GTCAGCTGTACCTGTCGCA
GGTCCCAATAGTAACTATA -> GTCCCAATAGTAACTATAG
GGTCGATGCCAACATACTA -> GTCGATGCCAACATACTAA
GGTCTAGCAATACTTCATT -> GTCTAGCAATACTTCATTC
GGTCTGATGACGATCGAGG -> GTCTGATGACGATCGAGGT
GGTCTTGACGTTTCTCGCG -> GTCTTGACGTTTCTCGCGG
GGTGAACAATACCCATTAT -> GTGAACAATACCCATTATA
GGTGAAGATCTTTCCCTGC -> GTGAAGATCTTTCCCTGCT
GGTGAGAAGGGGACTTGGA -> GTGAGAAGGGGACTTGGAA
GGTGCGCAGCCAATATCAG -> GTGCGCAGCCAATATCAGT
GGTGCTTGAAGCCCATTGG -> GTGCTTGAAGCCCATTGGT
GGTGGCATCTTGATTTTCT -> GTGGCATCTTGATTTTCTA
GGTGTCTGCACCACGCCGT -> GTGTCTGCACCACGCCGTC
GGTTAATGGTTACCCGGAC -> GTTAATGGTTACCCGGACC
GGTTACCCGGACCCAGATT -> GTTACCCGGACCCAGATTT
GGTTACGTACCCGAATGGC -> GTTACGTACCCGAATGGCG
GGTTATATCAAAGCGGGTA -> GTTATATCAAAGCGGGTAA
GGTTCAGCTTTAAGCTACT -> GTTCAGCTTTAAGCTACTA
GGTTTCACAGGCAGGTCTG -> GTTTCACAGGCAGGTCTGA
GGTTTGCATGTTCATCGAT -> GTTTGCATGTTCATCGATA
GGTTTGGAGTTGCGACACA -> GTTTGGAGTTGCGACACAC
GGTTTGGAGTTGCGACACC -> GTTTGGAGTTGCGACACCA
GGTTTGGAGTTGCGACACG -> GTTTGGAGTTGCGACACGA
GGTTTGGAGTTGCGACACT -> GTTTGGAGTTGCGACACTG
GTAAAGCGGGCTTTCTACC -> TAAAGCGGGCTTTCTACCG
GTAAAGGATAGGTCACCCC -> TAAAGGATAGGTCACCCCT
GTAAATTTGTCTTATTTCG -> TAAATTTGTCTTATTTCGG
GTAACGCCGTATGGTGCTT -> TAACGCCGTATGGTGCTTG
GTAACGCTATAGGTTTCAC -> TAACGCTATAGGTTTCACA
GTAACTATAGCTCCTTCAT -> TAACTATAGCTCCTTCATG
GTAACTCAGCGGGGTCCCA -> TAACTCAGCGGGGTCCCAA
GTAAGGATGAAACACGTCA -> TAAGGATGAAACACGTCAA
GTAATACATCTTATTCCCT -> TAATACATCTTATTCCCTG
GTAATGAAATTCAGGTTAA -> TAATGAAATTCAGGTTAAT
GTAATTGTTCCTCTTAATC -> TAATTGTTCCTCTTAATCC
GTACCCGAAAAAATTGGCA -> TACCCGAAAAAATTGGCAA
GTACCCGAATGGCGGATCC -> TACCCGAATGGCGGATCCC
GTACCTGTCGCAACATCGG -> TACCTGTCGCAACATCGGT
GTACGAACCTTCAAGAACG -> TACGAACCTTCAAGAACGC
GTACTTGTATATCACCTGA -> TACTTGTATATCACCTGAA
GTAGAAGATACATGGGGTA -> TAGAAGATACATGGGGTAT
GTAGACAGGGTTTGGAGTT -> TAGACAGGGTTTGGAGTTG
GTAGAGACCACTAACACTT -> TAGAGACCACTAACACTTG
GTAGCCCAGCTAAGGAAGC -> TAGCCCAGCTAAGGAAGCT
GTAGTAGAAGATACATGGG -> TAGTAGAAGATACATGGGG
GTATAAAACCCGAGGTTTG -> TATAAAACCCGAGGTTTGG
GTATATCACCTGAACAAAC -> TATATCACCTGAACAAACG
GTATCCGGACTCCACAGCC -> TATCCGGACTCCACAGCCT
GTATCCTCTAAGGCAACGT -> TATCCTCTAAGGCAACGTG
GTATGGTGCTTGAAGCCCA -> TATGGTGCTTGAAGCCCAT
GTATTACAGACATGAGCCT -> TATTACAGACATGAGCCTC
GTATTGGTGAACAATACCC -> TATTGGTGAACAATACCCA
GTCAACAACATAGCCCGGT -> TCAACAACATAGCCCGGTT
GTCAACCGATCAAATAGGT -> TCAACCGATCAAATAGGTG
GTCAAGAGTTTAAAGATCC -> TCAAGAGTTTAAAGATCCG
GTCAATTCTTGCGCTTTTT -> TCAATTCTTGCGCTTTTTG
GTCACAGATCTTTCCCTGC -> TCACAGATCTTTCCCTGCT
GTCACCCCTTGGAAATTTC -> TCACCCCTTGGAAATTTCC
GTCACGTTAGTGGCGCTGT -> TCACGTTAGTGGCGCTGTC
GTCACTGTAACGCCGTATG -> TCACTGTAACGCCGTATGG
GTCAGCGCAACCCTGCTCA -> TCAGCGCAACCCTGCTCAG
GTCAGCTGTACCTGTCGCA -> TCAGCTGTACCTGTCGCAA
GTCAGGATCTTAATATATT -> TCAGGATCTTAATATATTT
GTCCACCACATGTAATACA -> TCCACCACATGTAATACAT
GTCCAGCTAAAAAAGGCTT -> TCCAGCTAAAAAAGGCTTA
GTCCCAATAGTAACTATAG -> TCCCAATAGTAACTATAGC
GTCCCACAGATAATCCGGA -> TCCCACAGATAATCCGGAC
GTCCGAAATTCATTTCAGA -> TCCGAAATTCATTTCAGAG
GTCCGAAGAGTGCGACTTA -> TCCGAAGAGTGCGACTTAT
GTCCGGGGAACTTAGTATA -> TCCGGGGAACTTAGTATAA
GTCCGTTGGATCAGGCCAG -> TCCGTTGGATCAGGCCAGT
GTCGATGCCAACATACTAA -> TCGATGCCAACATACTAAC
GTCGCAACATCGGTTCAGC -> TCGCAACATCGGTTCAGCT
GTCGCAGCGCCGACGGATT -> TCGCAGCGCCGACGGATTA
GTCGTCACGTTAGTGGCGC -> TCGTCACGTTAGTGGCGCT
GTCTACGTCCGGGGAACTT -> TCTACGTCCGGGGAACTTA
GTCTAGCAATACTTCATTC -> TCTAGCAATACTTCATTCG
GTCTCAGACTTGCCAACGA -> TCTCAGACTTGCCAACGAA
GTCTCTGAGGCCTGGGGAT -> TCTCTGAGGCCTGGGGATG
GTCTGATGACGATCGAGGT -> TCTGATGACGATCGAGGTA
GTCTGCACCACGCCGTCCC -> TCTGCACCACGCCGTCCCA
GTCTGGGGGACCAGGGATC -> TCTGGGGGACCAGGGATCT
GTCTGTCGCAGCGCCGACG -> TCTGTCGCAGCGCCGACGG
GTCTTATTTCGGCTCCCAT -> TCTTATTTCGGCTCCCATG
GTCTTGACGTTTCTCGCGG -> TCTTGACGTTTCTCGCGGA
GTGAAACTGATTTAAAAGC -> TGAAACTGATTTAAAAGCA
GTGAAATCTACTTGGGGCA -> TGAAATCTACTTGGGGCAC
GTGAACAACGCCGCCAGTC -> TGAACAACGCCGCCAGTCA
GTGAACAATACCCATTATA -> TGAACAATACCCATTATAT
GTGAAGATCTTTCCCTGCT -> TGAAGATCTTTCCCTGCTG
GTGACCCTGGAATACGCCA -> TGACCCTGGAATACGCCAT
GTGACGTTGGTCAGCTGTA -> TGACGTTGGTCAGCTGTAC
GTGAGAACCACTGGGAGTC -> TGAGAACCACTGGGAGTCT
GTGAGAAGGGGACTTGGAA -> TGAGAAGGGGACTTGGAAA
GTGAGCAGCAGCCTCTGCG -> TGAGCAGCAGCCTCTGCGA
GTGAGGTGCGCAGCCAATA -> TGAGGTGCGCAGCCAATAT
GTGAGTGACGTTGGTCAGC -> TGAGTGACGTTGGTCAGCT
GTGCGACTTATTTACGAAC -> TGCGACTTATTTACGAACG
GTGCGCAGCCAATATCAGT -> TGCGCAGCCAATATCAGTC
GTGCGGGTCGATGCCAACA -> TGCGGGTCGATGCCAACAT
GTGCGTATTACAGACATGA -> TGCGTATTACAGACATGAG
GTGCTCAAACGACGTTGGG -> TGCTCAAACGACGTTGGGA
GTGCTGTGCTTCATTGACT -> TGCTGTGCTTCATTGACTG
GTGCTTCATTGACTGCGAA -> TGCTTCATTGACTGCGAAA
GTGCTTGAAGCCCATTGGT -> TGCTTGAAGCCCATTGGTT
GTGGATACATCAAGGTAAT -> TGGATACATCAAGGTAATG
GTGGCATCTTGATTTTCTA -> TGGCATCTTGATTTTCTAG
GTGGCGCTGTCCGTTGGAT -> TGGCGCTGTCCGTTGGATC
GTGGCGGGTACGAACCTTC -> TGGCGGGTACGAACCTTCA
GTGGGTGTCTGCACCACGC -> TGGGTGTCTGCACCACGCC
GTGTAAATTTGTCTTATTT -> TGTAAATTTGTCTTATTTC
GTGTCAGCGCAACCCTGCT -> TGTCAGCGCAACCCTGCTC
GTGTCTGCACCACGCCGTC -> TGTCTGCACCACGCCGTCC
GTTAATGGTTACCCGGACC -> TTAATGGTTACCCGGACCC
GTTACCCGGACCCAGATTT -> TTACCCGGACCCAGATTTA
GTTACGTACCCGAATGGCG -> TTACGTACCCGAATGGCGG
GTTACTAGGCATCGCAATA -> TTACTAGGCATCGCAATAC
GTTAGCCGTTGCTCGCCGC -> TTAGCCGTTGCTCGCCGCC
GTTAGGGGGCTGAGCTGAG -> TTAGGGGGCTGAGCTGAGC
GTTAGTGGCGCTGTCCGTT -> TTAGTGGCGCTGTCCGTTG
GTTATATCAAAGCGGGTAA -> TTATATCAAAGCGGGTAAT
GTTATGGCGGGGGACCCCG -> TTATGGCGGGGGACCCCGT
GTTATTATTCATCATGGGT -> TTATTATTCATCATGGGTT
GTTATTGCAACGTGTAAAT -> TTATTGCAACGTGTAAATT
GTTCAACTAAACGAGGCAT -> TTCAACTAAACGAGGCATC
GTTCAGCTTTAAGCTACTA -> TTCAGCTTTAAGCTACTAC
GTTCATCGATATGAGGCTT -> TTCATCGATATGAGGCTTT
GTTCCTCTTAATCCCGCTA -> TTCCTCTTAATCCCGCTAG
GTTCGCCGTTTAAGCCGAT -> TTCGCCGTTTAAGCCGATG
GTTGAATGATCTAAGAAGT -> TTGAATGATCTAAGAAGTG
GTTGCGACACACTGAGGTG -> TTGCGACACACTGAGGTGA
GTTGCGACACCATTTCTGA -> TTGCGACACCATTTCTGAA
GTTGCGACACGAGACGTCA -> TTGCGACACGAGACGTCAC
GTTGCGACACTGCTCGATG -> TTGCGACACTGCTCGATGG
GTTGCTCGCCGCCTCAGAA -> TTGCTCGCCGCCTCAGAAG
GTTGGATCAGGCCAGTACT -> TTGGATCAGGCCAGTACTT
GTTGGGAGGGCGGTAACTC -> TTGGGAGGGCGGTAACTCA
GTTGGGCGGTCTTGACGTT -> TTGGGCGGTCTTGACGTTT
GTTGGTAAAGGATAGGTCA -> TTGGTAAAGGATAGGTCAC
GTTGGTCAGCTGTACCTGT -> TTGGTCAGCTGTACCTGTC
GTTTAAAGATCCGTACCCG -> TTTAAAGATCCGTACCCGA
GTTTAAGCCGATGTTTAGT -> TTTAAGCCGATGTTTAGTC
GTTTAGTCCACCACATGTA -> TTTAGTCCACCACATGTAA
GTTTATCGTTAGCCGTTGC -> TTTATCGTTAGCCGTTGCT
GTTTCACAGGCAGGTCTGA -> TTTCACAGGCAGGTCTGAT
GTTTCTCGCGGACGCTGCA -> TTTCTCGCGGACGCTGCAA
GTTTGCATGTTCATCGATA -> TTTGCATGTTCATCGATAT
GTTTGGAGTTGCGACACAC -> TTTGGAGTTGCGACACACT
GTTTGGAGTTGCGACACCA -> TTTGGAGTTGCGACACCAT
GTTTGGAGTTGCGACACGA -> TTTGGAGTTGCGACACGAG
GTTTGGAGTTGCGACACTG -> TTTGGAGTTGCGACACTGC
TAAAAAAGGCTTACTGCTT -> AAAAAAGGCTTACTGCTTG
TAAAACCCGAGGTTTGGAG -> AAAACCCGAGGTTTGGAGT
TAAAAGCAGACACCGGGCT -> AAAAGCAGACACCGGGCTC
TAAAATGCTGCTAAGCCCT -> AAAATGCTGCTAAGCCCTG
TAAACGAGGCATCAATTCG -> AAACGAGGCATCAATTCGT
TAAAGAAGTTTATCGTTAG -> AAAGAAGTTTATCGTTAGC
TAAAGATCCGTACCCGAAA -> AAAGATCCGTACCCGAAAA
TAAAGCGGGCTTTCTACCG -> AAAGCGGGCTTTCTACCGA
TAAAGGATAGGTCACCCCT -> AAAGGATAGGTCACCCCTT
TAAATTTGTCTTATTTCGG -> AAATTTGTCTTATTTCGGC
TAACACTTGTGCGTATTAC -> AACACTTGTGCGTATTACA
TAACATGGCGCGCAAGGAT -> AACATGGCGCGCAAGGATT
TAACGCCGTATGGTGCTTG -> AACGCCGTATGGTGCTTGA
TAACGCTATAGGTTTCACA -> AACGCTATAGGTTTCACAG
TAACGGTTTGGAGTTGCGA -> AACGGTTTGGAGTTGCGAC
TAACTATAGCTCCTTCATG -> AACTATAGCTCCTTCATGA
TAACTCAGCGGGGTCCCAA -> AACTCAGCGGGGTCCCAAT
TAAGAAGTGACCCTGGAAT -> AAGAAGTGACCCTGGAATA
TAAGCCCTGTCTGGGGGAC -> AAGCCCTGTCTGGGGGACC
TAAGCCGATGTTTAGTCCA -> AAGCCGATGTTTAGTCCAC
TAAGCTACTACCAATAGAC -> AAGCTACTACCAATAGACG
TAAGGAAATACTCTTGTGC -> AAGGAAATACTCTTGTGCT
TAAGGAAGCTCTTATCCGA -> AAGGAAGCTCTTATCCGAA
TAAGGATGAAACACGTCAA -> AAGGATGAAACACGTCAAT
TAAGGCAACGTGTCAGCGC -> AAGGCAACGTGTCAGCGCA
TAATACATCTTATTCCCTG -> AATACATCTTATTCCCTGG
TAATACCATGTAACGCTAT -> AATACCATGTAACGCTATA
TAATATATTTAAAGAAGTT -> AATATATTTAAAGAAGTTT
TAATCAATTCGTGGCGGGT -> AATCAATTCGTGGCGGGTA
TAATCCCGCTAGTGCGGGT -> AATCCCGCTAGTGCGGGTC
TAATCCGGACTCACTAAAA -> AATCCGGACTCACTAAAAT
TAATGAAATTCAGGTTAAT -> AATGAAATTCAGGTTAATG
TAATGGTTACCCGGACCCA -> AATGGTTACCCGGACCCAG
TAATTGTTCCTCTTAATCC -> AATTGTTCCTCTTAATCCC
TACACGGGGCTTTGACGTT -> ACACGGGGCTTTGACGTTG
TACAGACATGAGCCTCTTG -> ACAGACATGAGCCTCTTGG
TACAGCCATCGTGAAACTG -> ACAGCCATCGTGAAACTGA
TACAGTCACTGTAACGCCG -> ACAGTCACTGTAACGCCGT
TACATCAAGGTAATGAAAT -> ACATCAAGGTAATGAAATT
TACATCTTATTCCCTGGGA -> ACATCTTATTCCCTGGGAT
TACATGGGGTATCCTCTAA -> ACATGGGGTATCCTCTAAG
TACCAATAGACGACTCGAT -> ACCAATAGACGACTCGATG
TACCATGTAACGCTATAGG -> ACCATGTAACGCTATAGGT
TACCCACGGCAATTAGGGC -> ACCCACGGCAATTAGGGCA
TACCCATTATATATGGCGT -> ACCCATTATATATGGCGTC
TACCCGAAAAAATTGGCAA -> ACCCGAAAAAATTGGCAAA
TACCCGAATGGCGGATCCC -> ACCCGAATGGCGGATCCCT
TACCCGGACCCAGATTTAT -> ACCCGGACCCAGATTTATA
TACCGAATCATACAGCCAT -> ACCGAATCATACAGCCATC
TACCGTCAGGATCTTAATA -> ACCGTCAGGATCTTAATAT
TACCTGTCGCAACATCGGT -> ACCTGTCGCAACATCGGTT
TACGAACCTTCAAGAACGC -> ACGAACCTTCAAGAACGCA
TACGAACGACGAGAGTTGG -> ACGAACGACGAGAGTTGGG
TACGCCATCGCAGAGTCTC -> ACGCCATCGCAGAGTCTCT
TACGCCTTTAGATCATTAC -> ACGCCTTTAGATCATTACC
TACGGTGAGAAGGGGACTT -> ACGGTGAGAAGGGGACTTG
TACGTACCCGAATGGCGGA -> ACGTACCCGAATGGCGGAT
TACGTCCGGGGAACTTAGT -> ACGTCCGGGGAACTTAGTA
TACTAACGGTTTGGAGTTG -> ACTAACGGTTTGGAGTTGC
TACTACCAATAGACGACTC -> ACTACCAATAGACGACTCG
TACTACGCCTTTAGATCAT -> ACTACGCCTTTAGATCATT
TACTAGGCATCGCAATACC -> ACTAGGCATCGCAATACCC
TACTATTTGTGAACAACGC -> ACTATTTGTGAACAACGCC
TACTCTTGTGCTGTGCTTC -> ACTCTTGTGCTGTGCTTCA
TACTTCATTCGGCTCAGGG -> ACTTCATTCGGCTCAGGGG
TACTTGGCATCCTTCTACA -> ACTTGGCATCCTTCTACAG
TACTTGGGGCACCTGATAT -> ACTTGGGGCACCTGATATG
TACTTGTATATCACCTGAA -> ACTTGTATATCACCTGAAC
TAGAAGATACATGGGGTAT -> AGAAGATACATGGGGTATC
TAGAATCATAGATTAATAC -> AGAATCATAGATTAATACC
TAGACAGGGTTTGGAGTTG -> AGACAGGGTTTGGAGTTGC
TAGACGACTCGATGCAAAG -> AGACGACTCGATGCAAAGA
TAGAGACCACTAACACTTG -> AGAGACCACTAACACTTGT
TAGATCATTACCGTCAGGA -> AGATCATTACCGTCAGGAT
TAGATTAATACCATGTAAC -> AGATTAATACCATGTAACG
TAGCAATACTTCATTCGGC -> AGCAATACTTCATTCGGCT
TAGCCCAGCTAAGGAAGCT -> AGCCCAGCTAAGGAAGCTC
TAGCCCCTCTAGTGAAATC -> AGCCCCTCTAGTGAAATCT
TAGCCCGGTTACGTACCCG -> AGCCCGGTTACGTACCCGA
TAGCCGTTGCTCGCCGCCT -> AGCCGTTGCTCGCCGCCTC
TAGCCTACACGGGGCTTTG -> AGCCTACACGGGGCTTTGA
TAGCTACTATTTGTGAACA -> AGCTACTATTTGTGAACAA
TAGCTCCTTCATGACTCGA -> AGCTCCTTCATGACTCGAC
TAGGCATCGCAATACCCAC -> AGGCATCGCAATACCCACG
TAGGGCAGCTATAACATGG -> AGGGCAGCTATAACATGGC
TAGGGGGCTGAGCTGAGCA -> AGGGGGCTGAGCTGAGCAA
TAGGGTCTAGCAATACTTC -> AGGGTCTAGCAATACTTCA
TAGGTCACCCCTTGGAAAT -> AGGTCACCCCTTGGAAATT
TAGGTGGCATCTTGATTTT -> AGGTGGCATCTTGATTTTC
TAGGTTTCACAGGCAGGTC -> AGGTTTCACAGGCAGGTCT
TAGTAACTATAGCTCCTTC -> AGTAACTATAGCTCCTTCA
TAGTAGAAGATACATGGGG -> AGTAGAAGATACATGGGGT
TAGTAGCCCAGCTAAGGAA -> AGTAGCCCAGCTAAGGAAG
TAGTATAAAACCCGAGGTT -> AGTATAAAACCCGAGGTTT
TAGTATTGGTGAACAATAC -> AGTATTGGTGAACAATACC
TAGTCCACCACATGTAATA -> AGTCCACCACATGTAATAC
TAGTGAAATCTACTTGGGG -> AGTGAAATCTACTTGGGGC
TAGTGCGGGTCGATGCCAA -> AGTGCGGGTCGATGCCAAC
TAGTGGCGCTGTCCGTTGG -> AGTGGCGCTGTCCGTTGGA
TAGTTAGGGGGCTGAGCTG -> AGTTAGGGGGCTGAGCTGA
TATAAAACCCGAGGTTTGG -> ATAAAACCCGAGGTTTGGA
TATAACATGGCGCGCAAGG -> ATAACATGGCGCGCAAGGA
TATACTACGCCTTTAGATC -> ATACTACGCCTTTAGATCA
TATAGCTCCTTCATGACTC -> ATAGCTCCTTCATGACTCG
TATAGGTTTCACAGGCAGG -> ATAGGTTTCACAGGCAGGT
TATATATGGCGTCCAGCTA -> ATATATGGCGTCCAGCTAA
TATATCAAAGCGGGTAATT -> ATATCAAAGCGGGTAATTG
TATATCACCTGAACAAACG -> ATATCACCTGAACAAACGT
TATATGGCGTCCAGCTAAA -> ATATGGCGTCCAGCTAAAA
TATATTATGCCGTGGGTGT -> ATATTATGCCGTGGGTGTC
TATATTTAAAGAAGTTTAT -> ATATTTAAAGAAGTTTATC
TATCAAAGCGGGTAATTGT -> ATCAAAGCGGGTAATTGTT
TATCACCTGAACAAACGTT -> ATCACCTGAACAAACGTTA
TATCAGTCCGAAATTCATT -> ATCAGTCCGAAATTCATTT
TATCCGAACCACCGTCAAG -> ATCCGAACCACCGTCAAGA
TATCCGGACTCCACAGCCT -> ATCCGGACTCCACAGCCTT
TATCCTCTAAGGCAACGTG -> ATCCTCTAAGGCAACGTGT
TATCGTTAGCCGTTGCTCG -> ATCGTTAGCCGTTGCTCGC
TATGAGGCTTTATTAGTAT -> ATGAGGCTTTATTAGTATT
TATGCCGTGGGTGTCTGCA -> ATGCCGTGGGTGTCTGCAC
TATGGAATCACGACTCAGG -> ATGGAATCACGACTCAGGA
TATGGCGGGGGACCCCGTT -> ATGGCGGGGGACCCCGTTG
TATGGCGTCCAGCTAAAAA -> ATGGCGTCCAGCTAAAAAA
TATGGTGCTTGAAGCCCAT -> ATGGTGCTTGAAGCCCATT
TATTACAGACATGAGCCTC -> ATTACAGACATGAGCCTCT
TATTAGTATTGGTGAACAA -> ATTAGTATTGGTGAACAAT
TATTATGCCGTGGGTGTCT -> ATTATGCCGTGGGTGTCTG
TATTATTCATCATGGGTTT -> ATTATTCATCATGGGTTTG
TATTCATCATGGGTTTGCA -> ATTCATCATGGGTTTGCAT
TATTCCCTGGGATTGATAA -> ATTCCCTGGGATTGATAAT
TATTGCAACGTGTAAATTT -> ATTGCAACGTGTAAATTTG
TATTGGTGAACAATACCCA -> ATTGGTGAACAATACCCAT
TATTGTCGTCACGTTAGTG -> ATTGTCGTCACGTTAGTGG
TATTTAAAGAAGTTTATCG -> ATTTAAAGAAGTTTATCGT
TATTTACGAACGACGAGAG -> ATTTACGAACGACGAGAGT
TATTTCGGCTCCCATGAAT -> ATTTCGGCTCCCATGAATG
TATTTGTGAACAACGCCGC -> ATTTGTGAACAACGCCGCC
TCAAACGACGTTGGGAGGG -> CAAACGACGTTGGGAGGGC
TCAAAGCGGGTAATTGTTC -> CAAAGCGGGTAATTGTTCC
TCAAATAGGTGGCATCTTG -> CAAATAGGTGGCATCTTGA
TCAACAACATAGCCCGGTT -> CAACAACATAGCCCGGTTA
TCAACCGATCAAATAGGTG -> CAACCGATCAAATAGGTGG
TCAACTAAACGAGGCATCA -> CAACTAAACGAGGCATCAA
TCAAGAACGCATTCCGTAA -> CAAGAACGCATTCCGTAAG
TCAAGAGTTTAAAGATCCG -> CAAGAGTTTAAAGATCCGT
TCAAGGTAATGAAATTCAG -> CAAGGTAATGAAATTCAGG
TCAATTCGTGGCGGGTACG -> CAATTCGTGGCGGGTACGA
TCAATTCGTTATTGCAACG -> CAATTCGTTATTGCAACGT
TCAATTCTTGCGCTTTTTG -> CAATTCTTGCGCTTTTTGA
TCACAGATCTTTCCCTGCT -> CACAGATCTTTCCCTGCTG
TCACAGGCAGGTCTGATGA -> CACAGGCAGGTCTGATGAC
TCACCCCTTGGAAATTTCC -> CACCCCTTGGAAATTTCCC
TCACCTGAACAAACGTTAT -> CACCTGAACAAACGTTATT
TCACGACTCAGGAGACATC -> CACGACTCAGGAGACATCT
TCACGTTAGTGGCGCTGTC -> CACGTTAGTGGCGCTGTCC
TCACTAAAATGCTGCTAAG -> CACTAAAATGCTGCTAAGC
TCACTGTAACGCCGTATGG -> CACTGTAACGCCGTATGGT
TCAGAAGCGTTCAACTAAA -> CAGAAGCGTTCAACTAAAC
TCAGACTTGCCAACGAAGC -> CAGACTTGCCAACGAAGCG
TCAGAGCATAGCTACTATT -> CAGAGCATAGCTACTATTT
TCAGCATCCTCCACTAGAA -> CAGCATCCTCCACTAGAAT
TCAGCGCAACCCTGCTCAG -> CAGCGCAACCCTGCTCAGC
TCAGCGGGGTCCCAATAGT -> CAGCGGGGTCCCAATAGTA
TCAGCTGTACCTGTCGCAA -> CAGCTGTACCTGTCGCAAC
TCAGCTTTAAGCTACTACC -> CAGCTTTAAGCTACTACCA
TCAGGAGACATCTTCATAT -> CAGGAGACATCTTCATATT
TCAGGATCTTAATATATTT -> CAGGATCTTAATATATTTA
TCAGGCCAGTACTTGTATA -> CAGGCCAGTACTTGTATAT
TCAGGGGCAGTTATGGCGG -> CAGGGGCAGTTATGGCGGG
TCAGGTTAATGGTTACCCG -> CAGGTTAATGGTTACCCGG
TCAGTCCGAAATTCATTTC -> CAGTCCGAAATTCATTTCA
TCAGTCTCAGACTTGCCAA -> CAGTCTCAGACTTGCCAAC
TCATACAGCCATCGTGAAA -> CATACAGCCATCGTGAAAC
TCATAGATTAATACCATGT -> CATAGATTAATACCATGTA
TCATATTGTCGTCACGTTA -> CATATTGTCGTCACGTTAG
TCATCATGGGTTTGCATGT -> CATCATGGGTTTGCATGTT
TCATCGATATGAGGCTTTA -> CATCGATATGAGGCTTTAT
TCATGACTCGACACCACTT -> CATGACTCGACACCACTTG
TCATGGGTTTGCATGTTCA -> CATGGGTTTGCATGTTCAT
TCATTACCGTCAGGATCTT -> CATTACCGTCAGGATCTTA
TCATTCGGCTCAGGGGCAG -> CATTCGGCTCAGGGGCAGT
TCATTGACTGCGAAACGCA -> CATTGACTGCGAAACGCAG
TCATTTCAGAGCATAGCTA -> CATTTCAGAGCATAGCTAC
TCCACAGCCTTGGCATAAG -> CCACAGCCTTGGCATAAGG
TCCACCACATGTAATACAT -> CCACCACATGTAATACATC
TCCACTAGAATCATAGATT -> CCACTAGAATCATAGATTA
TCCAGCTAAAAAAGGCTTA -> CCAGCTAAAAAAGGCTTAC
TCCCAATAGTAACTATAGC -> CCCAATAGTAACTATAGCT
TCCCACAGATAATCCGGAC -> CCCACAGATAATCCGGACT
TCCCATGAATGCACGGTAG -> CCCATGAATGCACGGTAGA
TCCCGCTAGTGCGGGTCGA -> CCCGCTAGTGCGGGTCGAT
TCCCTCGTCCGAAGAGTGC -> CCCTCGTCCGAAGAGTGCG
TCCCTGCTGTGAGAACCAC -> CCCTGCTGTGAGAACCACT
TCCCTGCTGTGAGCAGCAG -> CCCTGCTGTGAGCAGCAGC
TCCCTGCTGTGAGGTGCGC -> CCCTGCTGTGAGGTGCGCA
TCCCTGCTGTGAGTGACGT -> CCCTGCTGTGAGTGACGTT
TCCCTGGGATTGATAATCA -> CCCTGGGATTGATAATCAA
TCCCTTAGTAGCCCAGCTA -> CCCTTAGTAGCCCAGCTAA
TCCGAAATTCATTTCAGAG -> CCGAAATTCATTTCAGAGC
TCCGAACCACCGTCAAGAG -> CCGAACCACCGTCAAGAGT
TCCGAAGAGTGCGACTTAT -> CCGAAGAGTGCGACTTATT
TCCGGACTCACTAAAATGC -> CCGGACTCACTAAAATGCT
TCCGGACTCCACAGCCTTG -> CCGGACTCCACAGCCTTGG
TCCGGGGAACTTAGTATAA -> CCGGGGAACTTAGTATAAA
TCCGTAAGGATGAAACACG -> CCGTAAGGATGAAACACGT
TCCGTACCCGAAAAAATTG -> CCGTACCCGAAAAAATTGG
TCCGTTGGATCAGGCCAGT -> CCGTTGGATCAGGCCAGTA
TCCTCCACTAGAATCATAG -> CCTCCACTAGAATCATAGA
TCCTCTAAGGCAACGTGTC -> CCTCTAAGGCAACGTGTCA
TCCTCTTAATCCCGCTAGT -> CCTCTTAATCCCGCTAGTG
TCCTTCATGACTCGACACC -> CCTTCATGACTCGACACCA
TCCTTCTACAGTCACTGTA -> CCTTCTACAGTCACTGTAA
TCGACACCACTTGTCTGTC -> CGACACCACTTGTCTGTCG
TCGAGGTAAAGCGGGCTTT -> CGAGGTAAAGCGGGCTTTC
TCGATATGAGGCTTTATTA -> CGATATGAGGCTTTATTAG
TCGATGCAAAGAGGCAGTA -> CGATGCAAAGAGGCAGTAT
TCGATGCCAACATACTAAC -> CGATGCCAACATACTAACG
TCGATGGAGATCTTTCCCT -> CGATGGAGATCTTTCCCTG
TCGCAACATCGGTTCAGCT -> CGCAACATCGGTTCAGCTT
TCGCAATACCCACGGCAAT -> CGCAATACCCACGGCAATT
TCGCAGAGTCTCTGAGGCC -> CGCAGAGTCTCTGAGGCCT
TCGCAGCGCCGACGGATTA -> CGCAGCGCCGACGGATTAC
TCGCCGCCTCAGAAGCGTT -> CGCCGCCTCAGAAGCGTTC
TCGCCGTTTAAGCCGATGT -> CGCCGTTTAAGCCGATGTT
TCGCGGACGCTGCAAGCTA -> CGCGGACGCTGCAAGCTAG
TCGGCTCAGGGGCAGTTAT -> CGGCTCAGGGGCAGTTATG
TCGGCTCCCATGAATGCAC -> CGGCTCCCATGAATGCACG
TCGGTTCAGCTTTAAGCTA -> CGGTTCAGCTTTAAGCTAC
TCGTCACGTTAGTGGCGCT -> CGTCACGTTAGTGGCGCTG
TCGTCCGAAGAGTGCGACT -> CGTCCGAAGAGTGCGACTT
TCGTGAAACTGATTTAAAA -> CGTGAAACTGATTTAAAAG
TCGTGGCGGGTACGAACCT -> CGTGGCGGGTACGAACCTT
TCGTTAGCCGTTGCTCGCC -> CGTTAGCCGTTGCTCGCCG
TCGTTATTGCAACGTGTAA -> CGTTATTGCAACGTGTAAA
TCTAAGAAGTGACCCTGGA -> CTAAGAAGTGACCCTGGAA
TCTAAGGCAACGTGTCAGC -> CTAAGGCAACGTGTCAGCG
TCTACAGTCACTGTAACGC -> CTACAGTCACTGTAACGCC
TCTACCGAATCATACAGCC -> CTACCGAATCATACAGCCA
TCTACGTCCGGGGAACTTA -> CTACGTCCGGGGAACTTAG
TCTACTTGGGGCACCTGAT -> CTACTTGGGGCACCTGATA
TCTAGCAATACTTCATTCG -> CTAGCAATACTTCATTCGG
TCTAGCCTACACGGGGCTT -> CTAGCCTACACGGGGCTTT
TCTAGGGTCTAGCAATACT -> CTAGGGTCTAGCAATACTT
TCTAGTGAAATCTACTTGG -> CTAGTGAAATCTACTTGGG
TCTCAGACTTGCCAACGAA -> CTCAGACTTGCCAACGAAG
TCTCGCGGACGCTGCAAGC -> CTCGCGGACGCTGCAAGCT
TCTCTGAGGCCTGGGGATG -> CTCTGAGGCCTGGGGATGA
TCTGAAAGATCTTTCCCTG -> CTGAAAGATCTTTCCCTGC
TCTGAGGCCTGGGGATGAT -> CTGAGGCCTGGGGATGATA
TCTGATGACGATCGAGGTA -> CTGATGACGATCGAGGTAA
TCTGCACCACGCCGTCCCA -> CTGCACCACGCCGTCCCAC
TCTGCGAAGCGCGCGTGGA -> CTGCGAAGCGCGCGTGGAT
TCTGGGGGACCAGGGATCT -> CTGGGGGACCAGGGATCTG
TCTGTCGCAGCGCCGACGG -> CTGTCGCAGCGCCGACGGA
TCTGTTACTAGGCATCGCA -> CTGTTACTAGGCATCGCAA
TCTTAATATATTTAAAGAA -> CTTAATATATTTAAAGAAG
TCTTAATCCCGCTAGTGCG -> CTTAATCCCGCTAGTGCGG
TCTTATCCGAACCACCGTC -> CTTATCCGAACCACCGTCA
TCTTATTCCCTGGGATTGA -> CTTATTCCCTGGGATTGAT
TCTTATTTCGGCTCCCATG -> CTTATTTCGGCTCCCATGA
TCTTCATATTGTCGTCACG -> CTTCATATTGTCGTCACGT
TCTTGACGTTTCTCGCGGA -> CTTGACGTTTCTCGCGGAC
TCTTGATTTTCTAGGGTCT -> CTTGATTTTCTAGGGTCTA
TCTTGCGCTTTTTGATGTG -> CTTGCGCTTTTTGATGTGC
TCTTGGTTTGGAGTTGCGA -> CTTGGTTTGGAGTTGCGAC
TCTTGTGCTGTGCTTCATT -> CTTGTGCTGTGCTTCATTG
TCTTTCCCTGCTGTGAGAA -> CTTTCCCTGCTGTGAGAAC
TCTTTCCCTGCTGTGAGCA -> CTTTCCCTGCTGTGAGCAG
TCTTTCCCTGCTGTGAGGT -> CTTTCCCTGCTGTGAGGTG
TCTTTCCCTGCTGTGAGTG -> CTTTCCCTGCTGTGAGTGA
TGAAACACGTCAATTCTTG -> GAAACACGTCAATTCTTGC
TGAAACTGATTTAAAAGCA -> GAAACTGATTTAAAAGCAG
TGAAAGATCTTTCCCTGCT -> GAAAGATCTTTCCCTGCTG
TGAAATCTACTTGGGGCAC -> GAAATCTACTTGGGGCACC
TGAAATTCAGGTTAATGGT -> GAAATTCAGGTTAATGGTT
TGAACAAACGTTATTATTC -> GAACAAACGTTATTATTCA
TGAACAACGCCGCCAGTCA -> GAACAACGCCGCCAGTCAA
TGAACAATACCCATTATAT -> GAACAATACCCATTATATA
TGAAGATCTTTCCCTGCTG -> GAAGATCTTTCCCTGCTGT
TGAAGCCCATTGGTTATAT -> GAAGCCCATTGGTTATATC
TGAAGCGCGCTACTTGGCA -> GAAGCGCGCTACTTGGCAT
TGAATGATCTAAGAAGTGA -> GAATGATCTAAGAAGTGAC
TGAATGCACGGTAGACAGG -> GAATGCACGGTAGACAGGG
TGACCCTGGAATACGCCAT -> GACCCTGGAATACGCCATC
TGACGATCGAGGTAAAGCG -> GACGATCGAGGTAAAGCGG
TGACGTTGGTAAAGGATAG -> GACGTTGGTAAAGGATAGG
TGACGTTGGTCAGCTGTAC -> GACGTTGGTCAGCTGTACC
TGACGTTTCTCGCGGACGC -> GACGTTTCTCGCGGACGCT
TGACTCGACACCACTTGTC -> GACTCGACACCACTTGTCT
TGACTGCGAAACGCAGTAG -> GACTGCGAAACGCAGTAGA
TGAGAACCACTGGGAGTCT -> GAGAACCACTGGGAGTCTA
TGAGAAGGGGACTTGGAAA -> GAGAAGGGGACTTGGAAAG
TGAGCAAACTATACTACGC -> GAGCAAACTATACTACGCC
TGAGCAGCAGCCTCTGCGA -> GAGCAGCAGCCTCTGCGAA
TGAGCCTCTTGGTTTGGAG -> GAGCCTCTTGGTTTGGAGT
TGAGCTGAGCAAACTATAC -> GAGCTGAGCAAACTATACT
TGAGGCCTGGGGATGATAG -> GAGGCCTGGGGATGATAGT
TGAGGCTTTATTAGTATTG -> GAGGCTTTATTAGTATTGG
TGAGGTGAAGATCTTTCCC -> GAGGTGAAGATCTTTCCCT
TGAGGTGCGCAGCCAATAT -> GAGGTGCGCAGCCAATATC
TGAGTGACGTTGGTCAGCT -> GAGTGACGTTGGTCAGCTG
TGATAATCAATTCGTGGCG -> GATAATCAATTCGTGGCGG
TGATAGTTAGGGGGCTGAG -> GATAGTTAGGGGGCTGAGC
TGATATGGAATCACGACTC -> GATATGGAATCACGACTCA
TGATCTAAGAAGTGACCCT -> GATCTAAGAAGTGACCCTG
TGATGACGATCGAGGTAAA -> GATGACGATCGAGGTAAAG
TGATGTGCTCAAACGACGT -> GATGTGCTCAAACGACGTT
TGATTTAAAAGCAGACACC -> GATTTAAAAGCAGACACCG
TGATTTTCTAGGGTCTAGC -> GATTTTCTAGGGTCTAGCA
TGCAAAGAGGCAGTATCCG -> GCAAAGAGGCAGTATCCGG
TGCAACGTGTAAATTTGTC -> GCAACGTGTAAATTTGTCT
TGCAAGCTAGCCCCTCTAG -> GCAAGCTAGCCCCTCTAGT
TGCACCACGCCGTCCCACA -> GCACCACGCCGTCCCACAG
TGCACGGTAGACAGGGTTT -> GCACGGTAGACAGGGTTTG
TGCATGTTCATCGATATGA -> GCATGTTCATCGATATGAG
TGCCAACATACTAACGGTT -> GCCAACATACTAACGGTTT
TGCCAACGAAGCGAACGCT -> GCCAACGAAGCGAACGCTG
TGCCGTGGGTGTCTGCACC -> GCCGTGGGTGTCTGCACCA
TGCGAAACGCAGTAGAGAC -> GCGAAACGCAGTAGAGACC
TGCGAAGCGCGCGTGGATA -> GCGAAGCGCGCGTGGATAC
TGCGACACACTGAGGTGAA -> GCGACACACTGAGGTGAAG
TGCGACACCATTTCTGAAA -> GCGACACCATTTCTGAAAG
TGCGACACGAGACGTCACA -> GCGACACGAGACGTCACAG
TGCGACACTGCTCGATGGA -> GCGACACTGCTCGATGGAG
TGCGACTTATTTACGAACG -> GCGACTTATTTACGAACGA
TGCGCAGCCAATATCAGTC -> GCGCAGCCAATATCAGTCC
TGCGCTTTTTGATGTGCTC -> GCGCTTTTTGATGTGCTCA
TGCGGGTCGATGCCAACAT -> GCGGGTCGATGCCAACATA
TGCGTATTACAGACATGAG -> GCGTATTACAGACATGAGC
TGCTAAGCCCTGTCTGGGG -> GCTAAGCCCTGTCTGGGGG
TGCTCAAACGACGTTGGGA -> GCTCAAACGACGTTGGGAG
TGCTCAGCATCCTCCACTA -> GCTCAGCATCCTCCACTAG
TGCTCGATGGAGATCTTTC -> GCTCGATGGAGATCTTTCC
TGCTCGCCGCCTCAGAAGC -> GCTCGCCGCCTCAGAAGCG
TGCTGCTAAGCCCTGTCTG -> GCTGCTAAGCCCTGTCTGG
TGCTGTGAGAACCACTGGG -> GCTGTGAGAACCACTGGGA
TGCTGTGAGCAGCAGCCTC -> GCTGTGAGCAGCAGCCTCT
TGCTGTGAGGTGCGCAGCC -> GCTGTGAGGTGCGCAGCCA
TGCTGTGAGTGACGTTGGT -> GCTGTGAGTGACGTTGGTC
TGCTGTGCTTCATTGACTG -> GCTGTGCTTCATTGACTGC
TGCTTCATTGACTGCGAAA -> GCTTCATTGACTGCGAAAC
TGCTTGAAGCCCATTGGTT -> GCTTGAAGCCCATTGGTTA
TGGAAAGGTAGTAGAAGAT -> GGAAAGGTAGTAGAAGATA
TGGAAATTTCCCTCGTCCG -> GGAAATTTCCCTCGTCCGA
TGGAATACGCCATCGCAGA -> GGAATACGCCATCGCAGAG
TGGAATCACGACTCAGGAG -> GGAATCACGACTCAGGAGA
TGGAGATCTTTCCCTGCTG -> GGAGATCTTTCCCTGCTGT
TGGAGTTGCGACACACTGA -> GGAGTTGCGACACACTGAG
TGGAGTTGCGACACCATTT -> GGAGTTGCGACACCATTTC
TGGAGTTGCGACACGAGAC -> GGAGTTGCGACACGAGACG
TGGAGTTGCGACACTGCTC -> GGAGTTGCGACACTGCTCG
TGGATACATCAAGGTAATG -> GGATACATCAAGGTAATGA
TGGATCAGGCCAGTACTTG -> GGATCAGGCCAGTACTTGT
TGGCAAAGAGTTCGCCGTT -> GGCAAAGAGTTCGCCGTTT
TGGCATAAGGAAATACTCT -> GGCATAAGGAAATACTCTT
TGGCATCCTTCTACAGTCA -> GGCATCCTTCTACAGTCAC
TGGCATCTTGATTTTCTAG -> GGCATCTTGATTTTCTAGG
TGGCGCGCAAGGATTCTAG -> GGCGCGCAAGGATTCTAGC
TGGCGCTGTCCGTTGGATC -> GGCGCTGTCCGTTGGATCA
TGGCGGATCCCTTAGTAGC -> GGCGGATCCCTTAGTAGCC
TGGCGGGGGACCCCGTTGA -> GGCGGGGGACCCCGTTGAA
TGGCGGGTACGAACCTTCA -> GGCGGGTACGAACCTTCAA
TGGCGTCCAGCTAAAAAAG -> GGCGTCCAGCTAAAAAAGG
TGGGAGGGCGGTAACTCAG -> GGGAGGGCGGTAACTCAGC
TGGGAGTCTACGTCCGGGG -> GGGAGTCTACGTCCGGGGA
TGGGATTGATAATCAATTC -> GGGATTGATAATCAATTCG
TGGGCGGTCTTGACGTTTC -> GGGCGGTCTTGACGTTTCT
TGGGGATGATAGTTAGGGG -> GGGGATGATAGTTAGGGGG
TGGGGCACCTGATATGGAA -> GGGGCACCTGATATGGAAT
TGGGGGACCAGGGATCTGT -> GGGGGACCAGGGATCTGTT
TGGGGTATCCTCTAAGGCA -> GGGGTATCCTCTAAGGCAA
TGGGTGTCTGCACCACGCC -> GGGTGTCTGCACCACGCCG
TGGGTTTGCATGTTCATCG -> GGGTTTGCATGTTCATCGA
TGGTAAAGGATAGGTCACC -> GGTAAAGGATAGGTCACCC
TGGTCAGCTGTACCTGTCG -> GGTCAGCTGTACCTGTCGC
TGGTGAACAATACCCATTA -> GGTGAACAATACCCATTAT
TGGTGCTTGAAGCCCATTG -> GGTGCTTGAAGCCCATTGG
TGGTTACCCGGACCCAGAT -> GGTTACCCGGACCCAGATT
TGGTTATATCAAAGCGGGT -> GGTTATATCAAAGCGGGTA
TGGTTTGGAGTTGCGACAC -> GGTTTGGAGTTGCGACACT
TGTAAATTTGTCTTATTTC -> GTAAATTTGTCTTATTTCG
TGTAACGCCGTATGGTGCT -> GTAACGCCGTATGGTGCTT
TGTAACGCTATAGGTTTCA -> GTAACGCTATAGGTTTCAC
TGTAATACATCTTATTCCC -> GTAATACATCTTATTCCCT
TGTACCTGTCGCAACATCG -> GTACCTGTCGCAACATCGG
TGTATATCACCTGAACAAA -> GTATATCACCTGAACAAAC
TGTCAACCGATCAAATAGG -> GTCAACCGATCAAATAGGT
TGTCAGCGCAACCCTGCTC -> GTCAGCGCAACCCTGCTCA
TGTCCGTTGGATCAGGCCA -> GTCCGTTGGATCAGGCCAG
TGTCGCAACATCGGTTCAG -> GTCGCAACATCGGTTCAGC
TGTCGCAGCGCCGACGGAT -> GTCGCAGCGCCGACGGATT
TGTCGTCACGTTAGTGGCG -> GTCGTCACGTTAGTGGCGC
TGTCTGCACCACGCCGTCC -> GTCTGCACCACGCCGTCCC
TGTCTGGGGGACCAGGGAT -> GTCTGGGGGACCAGGGATC
TGTCTGTCGCAGCGCCGAC -> GTCTGTCGCAGCGCCGACG
TGTCTTATTTCGGCTCCCA -> GTCTTATTTCGGCTCCCAT
TGTGAACAACGCCGCCAGT -> GTGAACAACGCCGCCAGTC
TGTGAGAACCACTGGGAGT -> GTGAGAACCACTGGGAGTC
TGTGAGCAGCAGCCTCTGC -> GTGAGCAGCAGCCTCTGCG
TGTGAGGTGCGCAGCCAAT -> GTGAGGTGCGCAGCCAATA
TGTGAGTGACGTTGGTCAG -> GTGAGTGACGTTGGTCAGC
TGTGCGTATTACAGACATG -> GTGCGTATTACAGACATGA
TGTGCTCAAACGACGTTGG -> GTGCTCAAACGACGTTGGG
TGTGCTGTGCTTCATTGAC -> GTGCTGTGCTTCATTGACT
TGTGCTTCATTGACTGCGA -> GTGCTTCATTGACTGCGAA
TGTTACTAGGCATCGCAAT -> GTTACTAGGCATCGCAATA
TGTTCATCGATATGAGGCT -> GTTCATCGATATGAGGCTT
TGTTCCTCTTAATCCCGCT -> GTTCCTCTTAATCCCGCTA
TGTTTAGTCCACCACATGT -> GTTTAGTCCACCACATGTA
TTAAAAGCAGACACCGGGC -> TAAAAGCAGACACCGGGCT
TTAAAGAAGTTTATCGTTA -> TAAAGAAGTTTATCGTTAG
TTAAAGATCCGTACCCGAA -> TAAAGATCCGTACCCGAAA
TTAAGCCGATGTTTAGTCC -> TAAGCCGATGTTTAGTCCA
TTAAGCTACTACCAATAGA -> TAAGCTACTACCAATAGAC
TTAATACCATGTAACGCTA -> TAATACCATGTAACGCTAT
TTAATATATTTAAAGAAGT -> TAATATATTTAAAGAAGTT
TTAATCCCGCTAGTGCGGG -> TAATCCCGCTAGTGCGGGT
TTAATGGTTACCCGGACCC -> TAATGGTTACCCGGACCCA
TTACAGACATGAGCCTCTT -> TACAGACATGAGCCTCTTG
TTACCCGGACCCAGATTTA -> TACCCGGACCCAGATTTAT
TTACCGTCAGGATCTTAAT -> TACCGTCAGGATCTTAATA
TTACGAACGACGAGAGTTG -> TACGAACGACGAGAGTTGG
TTACGGTGAGAAGGGGACT -> TACGGTGAGAAGGGGACTT
TTACGTACCCGAATGGCGG -> TACGTACCCGAATGGCGGA
TTACTAGGCATCGCAATAC -> TACTAGGCATCGCAATACC
TTAGATCATTACCGTCAGG -> TAGATCATTACCGTCAGGA
TTAGCCGTTGCTCGCCGCC -> TAGCCGTTGCTCGCCGCCT
TTAGGGCAGCTATAACATG -> TAGGGCAGCTATAACATGG
TTAGGGGGCTGAGCTGAGC -> TAGGGGGCTGAGCTGAGCA
TTAGTAGCCCAGCTAAGGA -> TAGTAGCCCAGCTAAGGAA
TTAGTATAAAACCCGAGGT -> TAGTATAAAACCCGAGGTT
TTAGTATTGGTGAACAATA -> TAGTATTGGTGAACAATAC
TTAGTCCACCACATGTAAT -> TAGTCCACCACATGTAATA
TTAGTGGCGCTGTCCGTTG -> TAGTGGCGCTGTCCGTTGG
TTATATATGGCGTCCAGCT -> TATATATGGCGTCCAGCTA
TTATATCAAAGCGGGTAAT -> TATATCAAAGCGGGTAATT
TTATATTATGCCGTGGGTG -> TATATTATGCCGTGGGTGT
TTATCCGAACCACCGTCAA -> TATCCGAACCACCGTCAAG
TTATCGTTAGCCGTTGCTC -> TATCGTTAGCCGTTGCTCG
TTATGCCGTGGGTGTCTGC -> TATGCCGTGGGTGTCTGCA
TTATGGCGGGGGACCCCGT -> TATGGCGGGGGACCCCGTT
TTATTAGTATTGGTGAACA -> TATTAGTATTGGTGAACAA
TTATTATTCATCATGGGTT -> TATTATTCATCATGGGTTT
TTATTCATCATGGGTTTGC -> TATTCATCATGGGTTTGCA
TTATTCCCTGGGATTGATA -> TATTCCCTGGGATTGATAA
TTATTGCAACGTGTAAATT -> TATTGCAACGTGTAAATTT
TTATTTACGAACGACGAGA -> TATTTACGAACGACGAGAG
TTATTTCGGCTCCCATGAA -> TATTTCGGCTCCCATGAAT
TTCAACTAAACGAGGCATC -> TCAACTAAACGAGGCATCA
TTCAAGAACGCATTCCGTA -> TCAAGAACGCATTCCGTAA
TTCACAGGCAGGTCTGATG -> TCACAGGCAGGTCTGATGA
TTCAGAGCATAGCTACTAT -> TCAGAGCATAGCTACTATT
TTCAGCTTTAAGCTACTAC -> TCAGCTTTAAGCTACTACC
TTCAGGTTAATGGTTACCC -> TCAGGTTAATGGTTACCCG
TTCATATTGTCGTCACGTT -> TCATATTGTCGTCACGTTA
TTCATCATGGGTTTGCATG -> TCATCATGGGTTTGCATGT
TTCATCGATATGAGGCTTT -> TCATCGATATGAGGCTTTA
TTCATGACTCGACACCACT -> TCATGACTCGACACCACTT
TTCATTCGGCTCAGGGGCA -> TCATTCGGCTCAGGGGCAG
TTCATTGACTGCGAAACGC -> TCATTGACTGCGAAACGCA
TTCATTTCAGAGCATAGCT -> TCATTTCAGAGCATAGCTA
TTCCCTCGTCCGAAGAGTG -> TCCCTCGTCCGAAGAGTGC
TTCCCTGCTGTGAGAACCA -> TCCCTGCTGTGAGAACCAC
TTCCCTGCTGTGAGCAGCA -> TCCCTGCTGTGAGCAGCAG
TTCCCTGCTGTGAGGTGCG -> TCCCTGCTGTGAGGTGCGC
TTCCCTGCTGTGAGTGACG -> TCCCTGCTGTGAGTGACGT
TTCCCTGGGATTGATAATC -> TCCCTGGGATTGATAATCA
TTCCGTAAGGATGAAACAC -> TCCGTAAGGATGAAACACG
TTCCTCTTAATCCCGCTAG -> TCCTCTTAATCCCGCTAGT
TTCGCCGTTTAAGCCGATG -> TCGCCGTTTAAGCCGATGT
TTCGGCTCAGGGGCAGTTA -> TCGGCTCAGGGGCAGTTAT
TTCGGCTCCCATGAATGCA -> TCGGCTCCCATGAATGCAC
TTCGTGGCGGGTACGAACC -> TCGTGGCGGGTACGAACCT
TTCGTTATTGCAACGTGTA -> TCGTTATTGCAACGTGTAA
TTCTACAGTCACTGTAACG -> TCTACAGTCACTGTAACGC
TTCTACCGAATCATACAGC -> TCTACCGAATCATACAGCC
TTCTAGCCTACACGGGGCT -> TCTAGCCTACACGGGGCTT
TTCTAGGGTCTAGCAATAC -> TCTAGGGTCTAGCAATACT
TTCTCGCGGACGCTGCAAG -> TCTCGCGGACGCTGCAAGC
TTCTGAAAGATCTTTCCCT -> TCTGAAAGATCTTTCCCTG
TTCTTGCGCTTTTTGATGT -> TCTTGCGCTTTTTGATGTG
TTGAAGCCCATTGGTTATA -> TGAAGCCCATTGGTTATAT
TTGAATGATCTAAGAAGTG -> TGAATGATCTAAGAAGTGA
TTGACGTTGGTAAAGGATA -> TGACGTTGGTAAAGGATAG
TTGACGTTTCTCGCGGACG -> TGACGTTTCTCGCGGACGC
TTGACTGCGAAACGCAGTA -> TGACTGCGAAACGCAGTAG
TTGATAATCAATTCGTGGC -> TGATAATCAATTCGTGGCG
TTGATGTGCTCAAACGACG -> TGATGTGCTCAAACGACGT
TTGATTTTCTAGGGTCTAG -> TGATTTTCTAGGGTCTAGC
TTGCAACGTGTAAATTTGT -> TGCAACGTGTAAATTTGTC
TTGCATGTTCATCGATATG -> TGCATGTTCATCGATATGA
TTGCCAACGAAGCGAACGC -> TGCCAACGAAGCGAACGCT
TTGCGACACACTGAGGTGA -> TGCGACACACTGAGGTGAA
TTGCGACACCATTTCTGAA -> TGCGACACCATTTCTGAAA
TTGCGACACGAGACGTCAC -> TGCGACACGAGACGTCACA
TTGCGACACTGCTCGATGG -> TGCGACACTGCTCGATGGA
TTGCGCTTTTTGATGTGCT -> TGCGCTTTTTGATGTGCTC
TTGCTCGCCGCCTCAGAAG -> TGCTCGCCGCCTCAGAAGC
TTGGAAAGGTAGTAGAAGA -> TGGAAAGGTAGTAGAAGAT
TTGGAAATTTCCCTCGTCC -> TGGAAATTTCCCTCGTCCG
TTGGAGTTGCGACACACTG -> TGGAGTTGCGACACACTGA
TTGGAGTTGCGACACCATT -> TGGAGTTGCGACACCATTT
TTGGAGTTGCGACACGAGA -> TGGAGTTGCGACACGAGAC
TTGGAGTTGCGACACTGCT -> TGGAGTTGCGACACTGCTC
TTGGATCAGGCCAGTACTT -> TGGATCAGGCCAGTACTTG
TTGGCAAAGAGTTCGCCGT -> TGGCAAAGAGTTCGCCGTT
TTGGCATAAGGAAATACTC -> TGGCATAAGGAAATACTCT
TTGGCATCCTTCTACAGTC -> TGGCATCCTTCTACAGTCA
TTGGGAGGGCGGTAACTCA -> TGGGAGGGCGGTAACTCAG
TTGGGCGGTCTTGACGTTT -> TGGGCGGTCTTGACGTTTC
TTGGGGCACCTGATATGGA -> TGGGGCACCTGATATGGAA
TTGGTAAAGGATAGGTCAC -> TGGTAAAGGATAGGTCACC
TTGGTCAGCTGTACCTGTC -> TGGTCAGCTGTACCTGTCG
TTGGTGAACAATACCCATT -> TGGTGAACAATACCCATTA
TTGGTTATATCAAAGCGGG -> TGGTTATATCAAAGCGGGT
TTGGTTTGGAGTTGCGACA -> TGGTTTGGAGTTGCGACAC
TTGTATATCACCTGAACAA -> TGTATATCACCTGAACAAA
TTGTCGTCACGTTAGTGGC -> TGTCGTCACGTTAGTGGCG
TTGTCTGTCGCAGCGCCGA -> TGTCTGTCGCAGCGCCGAC
TTGTCTTATTTCGGCTCCC -> TGTCTTATTTCGGCTCCCA
TTGTGAACAACGCCGCCAG -> TGTGAACAACGCCGCCAGT
TTGTGCGTATTACAGACAT -> TGTGCGTATTACAGACATG
TTGTGCTGTGCTTCATTGA -> TGTGCTGTGCTTCATTGAC
TTGTTCCTCTTAATCCCGC -> TGTTCCTCTTAATCCCGCT
TTTAAAAGCAGACACCGGG -> TTAAAAGCAGACACCGGGC
TTTAAAGAAGTTTATCGTT -> TTAAAGAAGTTTATCGTTA
TTTAAAGATCCGTACCCGA -> TTAAAGATCCGTACCCGAA
TTTAAGCCGATGTTTAGTC -> TTAAGCCGATGTTTAGTCC
TTTAAGCTACTACCAATAG -> TTAAGCTACTACCAATAGA
TTTACGAACGACGAGAGTT -> TTACGAACGACGAGAGTTG
TTTAGATCATTACCGTCAG -> TTAGATCATTACCGTCAGG
TTTAGTCCACCACATGTAA -> TTAGTCCACCACATGTAAT
TTTATATTATGCCGTGGGT -> TTATATTATGCCGTGGGTG
TTTATCGTTAGCCGTTGCT -> TTATCGTTAGCCGTTGCTC
TTTATTAGTATTGGTGAAC -> TTATTAGTATTGGTGAACA
TTTCACAGGCAGGTCTGAT -> TTCACAGGCAGGTCTGATG
TTTCAGAGCATAGCTACTA -> TTCAGAGCATAGCTACTAT
TTTCCCTCGTCCGAAGAGT -> TTCCCTCGTCCGAAGAGTG
TTTCCCTGCTGTGAGAACC -> TTCCCTGCTGTGAGAACCA
TTTCCCTGCTGTGAGCAGC -> TTCCCTGCTGTGAGCAGCA
TTTCCCTGCTGTGAGGTGC -> TTCCCTGCTGTGAGGTGCG
TTTCCCTGCTGTGAGTGAC -> TTCCCTGCTGTGAGTGACG
TTTCGGCTCCCATGAATGC -> TTCGGCTCCCATGAATGCA
TTTCTACCGAATCATACAG -> TTCTACCGAATCATACAGC
TTTCTAGGGTCTAGCAATA -> TTCTAGGGTCTAGCAATAC
TTTCTCGCGGACGCTGCAA -> TTCTCGCGGACGCTGCAAG
TTTCTGAAAGATCTTTCCC -> TTCTGAAAGATCTTTCCCT
TTTGACGTTGGTAAAGGAT -> TTGACGTTGGTAAAGGATA
TTTGATGTGCTCAAACGAC -> TTGATGTGCTCAAACGACG
TTTGCATGTTCATCGATAT -> TTGCATGTTCATCGATATG
TTTGGAGTTGCGACACACT -> TTGGAGTTGCGACACACTG
TTTGGAGTTGCGACACCAT -> TTGGAGTTGCGACACCATT
TTTGGAGTTGCGACACGAG -> TTGGAGTTGCGACACGAGA
TTTGGAGTTGCGACACTGC -> TTGGAGTTGCGACACTGCT
TTTGTCTTATTTCGGCTCC -> TTGTCTTATTTCGGCTCCC
TTTGTGAACAACGCCGCCA -> TTGTGAACAACGCCGCCAG
TTTTCTAGGGTCTAGCAAT -> TTTCTAGGGTCTAGCAATA
TTTTGATGTGCTCAAACGA -> TTTGATGTGCTCAAACGAC
TTTTTGATGTGCTCAAACG -> TTTTGATGTGCTCAAACGA
