GCTGTTAAGCGCCAGCCTCT -> CTGTTAAGCGCCAGCCTCTT
TTGCCGCCGGCTAGTACACT -> TGCCGCCGGCTAGTACACTT
GTAATGCTAAGCTACGGGAT -> TAATGCTAAGCTACGGGATG
AATTCTGTTTGACATGACCT -> ATTCTGTTTGACATGACCTG
GAGAAGAGCGAGTTTTTCAG -> AGAAGAGCGAGTTTTTCAGC
CCTCTATTGGGTAGCAACCG -> CTCTATTGGGTAGCAACCGG
CGCGAACGGCATTATATCTT -> GCGAACGGCATTATATCTTG
AAAATTCTGTTTGACATGAC -> AAATTCTGTTTGACATGACC
CTAGACCCCGGTAGGATACA -> TAGACCCCGGTAGGATACAG
ATCGCAGGAACGGAGCGTCA -> TCGCAGGAACGGAGCGTCAA
CACCATGATTAGACTCGTAA -> ACCATGATTAGACTCGTAAC
ACCATCTAAGTTAGTGTGAC -> CCATCTAAGTTAGTGTGACT
GCTTCCACCAGACCATCTTA -> CTTCCACCAGACCATCTTAG
TGAGAAAAATTCTGTTTGAC -> GAGAAAAATTCTGTTTGACA
ACCATGATTAGACTCGTAAC -> CCATGATTAGACTCGTAACA
AAAGAAGGTTAGGAGTGTTA -> AAGAAGGTTAGGAGTGTTAA
CGATGCTTGAGCTAGTGAGA -> GATGCTTGAGCTAGTGAGAA
CAAACAGGAGGGGTCCCCGG -> AAACAGGAGGGGTCCCCGGC
CAGTCATTTAGACTTTAACG -> AGTCATTTAGACTTTAACGA
TTTTCAGCTTCCACCAGACC -> TTTCAGCTTCCACCAGACCA
CTGTTAAGCGCCAGCCTCTT -> TGTTAAGCGCCAGCCTCTTA
TCAGTCATTTAGACTTTAAC -> CAGTCATTTAGACTTTAACG
TGTGGCCTCTTTTAGTATCC -> GTGGCCTCTTTTAGTATCCA
CCATGATTAGACTCGTAACA -> CATGATTAGACTCGTAACAC
GCCCGAGAGAGTCGTACCTG -> CCCGAGAGAGTCGTACCTGG
TACCTGGCAACCCGCCCTTC -> ACCTGGCAACCCGCCCTTCC
ACCGCGCTATCCCCATTTCC -> CCGCGCTATCCCCATTTCCC
TGACTATGTTTAGTGTGAGT -> GACTATGTTTAGTGTGAGTT
TGCTAAGCTACGGGATGCCC -> GCTAAGCTACGGGATGCCCC
CGCAGGAACGGAGCGTCAAA -> GCAGGAACGGAGCGTCAAAC
CCTTCCTGACAGAATTTCAA -> CTTCCTGACAGAATTTCAAA
AGAATTTCAAAATCGCAGGA -> GAATTTCAAAATCGCAGGAA
CCTGACAGAATTTCAAAATC -> CTGACAGAATTTCAAAATCG
CCAGACCATCTTAGTATTGC -> CAGACCATCTTAGTATTGCC
ACAGGAGGGGTCCCCGGCAG -> CAGGAGGGGTCCCCGGCAGG
CACATTCTAAAGTACAGACC -> ACATTCTAAAGTACAGACCA
TGATTAGACTCGTAACACAT -> GATTAGACTCGTAACACATT
AGTATTGCCGCCGGCTAGTA -> GTATTGCCGCCGGCTAGTAC
CAGCCTAGTCGCGGGGGCTG -> AGCCTAGTCGCGGGGGCTGT
CCCGGTAGGATACAGGGGCA -> CCGGTAGGATACAGGGGCAA
CGAGTTTTTCAGCTTCCACC -> GAGTTTTTCAGCTTCCACCA
GCGAGTTACGAATGGAGTTA -> CGAGTTACGAATGGAGTTAG
ATAGGCGCACTTTTAGAGGG -> TAGGCGCACTTTTAGAGGGA
ATGAGAATGACTTGCAGCGT -> TGAGAATGACTTGCAGCGTC
CCGCCGGCTAGTACACTTGA -> CGCCGGCTAGTACACTTGAC
CCATCTTAGTATTGCCGCCG -> CATCTTAGTATTGCCGCCGG
CTACCTGGATCTCGCATCGC -> TACCTGGATCTCGCATCGCA
GTCGACGTGAAAATAAAGAA -> TCGACGTGAAAATAAAGAAG
TAGTGTGAGTTTCTACCCTA -> AGTGTGAGTTTCTACCCTAA
GACACCTCCATTTAGCTTAT -> ACACCTCCATTTAGCTTATG
GAGTCGTACCTGGCAACCCG -> AGTCGTACCTGGCAACCCGC
GAGAGAGTCGTACCTGGCAA -> AGAGAGTCGTACCTGGCAAC
GAGAAACAACATTAAGCGAG -> AGAAACAACATTAAGCGAGT
TACTTTACTTCACTACGCAT -> ACTTTACTTCACTACGCATG
ACCCTAAATAAACATGTAAC -> CCCTAAATAAACATGTAACC
AGTAATGCTAAGCTACGGGA -> GTAATGCTAAGCTACGGGAT
GGCGCACTTTTAGAGGGACA -> GCGCACTTTTAGAGGGACAT
AAAATGCTTGACCTCTATTG -> AAATGCTTGACCTCTATTGG
GTCCCCGGCAGGTTGCTCTC -> TCCCCGGCAGGTTGCTCTCA
ACATGTAACCAAAATGCTTG -> CATGTAACCAAAATGCTTGA
GCCAGGCGACGCACTGGAAT -> CCAGGCGACGCACTGGAATA
CTTGAGGCTTAATTCCTCAC -> TTGAGGCTTAATTCCTCACG
TAGGATACAGGGGCAAGCAT -> AGGATACAGGGGCAAGCATG
TCCCCATTTCCCGGGTGTCA -> CCCCATTTCCCGGGTGTCAA
GACAGCCTAGTCGCGGGGGC -> ACAGCCTAGTCGCGGGGGCT
AGTTTCTACCCTAAATAAAC -> GTTTCTACCCTAAATAAACA
TTACTTTACTTCACTACGCA -> TACTTTACTTCACTACGCAT
AGTGTGACTATGTTTAGTGT -> GTGTGACTATGTTTAGTGTG
GAAGGTTAGGAGTGTTAAAG -> AAGGTTAGGAGTGTTAAAGT
GGCCTCTTTTAGTATCCACC -> GCCTCTTTTAGTATCCACCA
CTAAATAAACATGTAACCAA -> TAAATAAACATGTAACCAAA
TTAGGAGTGTTAAAGTTCCT -> TAGGAGTGTTAAAGTTCCTA
TTGACGATGAAGCATTAACA -> TGACGATGAAGCATTAACAG
CCGGCAGGTTGCTCTCAGCT -> CGGCAGGTTGCTCTCAGCTG
TACACTTGACGATGAAGCAT -> ACACTTGACGATGAAGCATT
TACGAATGGAGTTAGTTACA -> ACGAATGGAGTTAGTTACAC
TAGTATTGCCGCCGGCTAGT -> AGTATTGCCGCCGGCTAGTA
CCCCTACCTGGATCTCGCAT -> CCCTACCTGGATCTCGCATC
CGCAACAAGACAGCCTAGTC -> GCAACAAGACAGCCTAGTCG
GACTTTAACGAATTGCAGAC -> ACTTTAACGAATTGCAGACC
GCGCCCCTACCTGGATCTCG -> CGCCCCTACCTGGATCTCGC
AAAATCGCAGGAACGGAGCG -> AAATCGCAGGAACGGAGCGT
TATGTTTAGTGTGAGTTTCT -> ATGTTTAGTGTGAGTTTCTA
CTTGCAGCGTCATCCCCGAA -> TTGCAGCGTCATCCCCGAAG
TTAGAGGGACATTCTACGAG -> TAGAGGGACATTCTACGAGA
TGGAATACGAGAAGAGCGAG -> GGAATACGAGAAGAGCGAGT
AGGAGTGTTAAAGTTCCTAG -> GGAGTGTTAAAGTTCCTAGA
AATCGCAGGAACGGAGCGTC -> ATCGCAGGAACGGAGCGTCA
CTACGAGAAACAACATTAAG -> TACGAGAAACAACATTAAGC
AGACCATCTTAGTATTGCCG -> GACCATCTTAGTATTGCCGC
TGTAACCAAAATGCTTGACC -> GTAACCAAAATGCTTGACCT
CCTCTTTTAGTATCCACCAT -> CTCTTTTAGTATCCACCATG
CCCCGAAATCATGAGAATGA -> CCCGAAATCATGAGAATGAC
AAATCGCAGGAACGGAGCGT -> AATCGCAGGAACGGAGCGTC
AACCCGCCCTTCCTGACAGA -> ACCCGCCCTTCCTGACAGAA
AACACATTCTAAAGTACAGA -> ACACATTCTAAAGTACAGAC
GCATGTGGCCTCTTTTAGTA -> CATGTGGCCTCTTTTAGTAT
AACCATCTAAGTTAGTGTGA -> ACCATCTAAGTTAGTGTGAC
CACTTGACGATGAAGCATTA -> ACTTGACGATGAAGCATTAA
GGTAGCAACCGGCTTACTAT -> GTAGCAACCGGCTTACTATT
ACGTAATATTAACCCAGTAA -> CGTAATATTAACCCAGTAAT
TTCCGGATTGCCCTCACCTT -> TCCGGATTGCCCTCACCTTT
AGTTCCTAGACCCCGGTAGG -> GTTCCTAGACCCCGGTAGGA
AAAGTACAGACCAGTTCCGG -> AAGTACAGACCAGTTCCGGA
AGTTTTTCAGCTTCCACCAG -> GTTTTTCAGCTTCCACCAGA
GAAACAACATTAAGCGAGTT -> AAACAACATTAAGCGAGTTA
AGTACAGACCAGTTCCGGAT -> GTACAGACCAGTTCCGGATT
ACATGACCTGTCAATAGGCG -> CATGACCTGTCAATAGGCGC
GGACGTATCAGTCATTTAGA -> GACGTATCAGTCATTTAGAC
CTAAGGTGGAACAGGTCGAC -> TAAGGTGGAACAGGTCGACG
TAGTTACACCCGCGCCCCTA -> AGTTACACCCGCGCCCCTAC
AAGTCGCCGATGCTTGAGCT -> AGTCGCCGATGCTTGAGCTA
ACCTGGCAACCCGCCCTTCC -> CCTGGCAACCCGCCCTTCCT
CGGCTAGTACACTTGACGAT -> GGCTAGTACACTTGACGATG
GTGGAACAGGTCGACGTGAA -> TGGAACAGGTCGACGTGAAA
CATCTAAGTTAGTGTGACTA -> ATCTAAGTTAGTGTGACTAT
CCGGTAGGATACAGGGGCAA -> CGGTAGGATACAGGGGCAAG
TGCCCTCACCTTTGCCAGGC -> GCCCTCACCTTTGCCAGGCG
TTAGTATCCACCATGATTAG -> TAGTATCCACCATGATTAGA
CATCTGCGCACGAAGGACGT -> ATCTGCGCACGAAGGACGTA
AGAGCGAGTTTTTCAGCTTC -> GAGCGAGTTTTTCAGCTTCC
GCAGGAACGGAGCGTCAAAC -> CAGGAACGGAGCGTCAAACA
GTGACTATGTTTAGTGTGAG -> TGACTATGTTTAGTGTGAGT
TACACCCGCGCCCCTACCTG -> ACACCCGCGCCCCTACCTGG
TGGCGTTCGCCTTGAGGCTT -> GGCGTTCGCCTTGAGGCTTA
TTGCCCTCACCTTTGCCAGG -> TGCCCTCACCTTTGCCAGGC
AGGTTGCTCTCAGCTGCATG -> GGTTGCTCTCAGCTGCATGT
TTTAGCTTATGCGGTTATTC -> TTAGCTTATGCGGTTATTCT
AGACCGCGCTATCCCCATTT -> GACCGCGCTATCCCCATTTC
GCGCTATCCCCATTTCCCGG -> CGCTATCCCCATTTCCCGGG
ATTCCTCACGTAATATTAAC -> TTCCTCACGTAATATTAACC
GCTATCCCCATTTCCCGGGT -> CTATCCCCATTTCCCGGGTG
ATCGCAACAAGACAGCCTAG -> TCGCAACAAGACAGCCTAGT
GCCGGCTAGTACACTTGACG -> CCGGCTAGTACACTTGACGA
TCCACCAGACCATCTTAGTA -> CCACCAGACCATCTTAGTAT
GGCGTTCGCCTTGAGGCTTA -> GCGTTCGCCTTGAGGCTTAA
AACAGTTAAGGTACTATAGA -> ACAGTTAAGGTACTATAGAG
AGAAAAATTCTGTTTGACAT -> GAAAAATTCTGTTTGACATG
CCGGGTGTCAACGACACCTC -> CGGGTGTCAACGACACCTCC
GCACGAAGGACGTATCAGTC -> CACGAAGGACGTATCAGTCA
GGAACGGAGCGTCAAACAGG -> GAACGGAGCGTCAAACAGGA
TTGAGGCTTAATTCCTCACG -> TGAGGCTTAATTCCTCACGT
CTTCCTGACAGAATTTCAAA -> TTCCTGACAGAATTTCAAAA
TGTCAATAGGCGCACTTTTA -> GTCAATAGGCGCACTTTTAG
TGAGAATGACTTGCAGCGTC -> GAGAATGACTTGCAGCGTCA
ACTTTACTTCACTACGCATG -> CTTTACTTCACTACGCATGG
AGAGCCATTCTAACCATCTA -> GAGCCATTCTAACCATCTAA
CTGTCAATAGGCGCACTTTT -> TGTCAATAGGCGCACTTTTA
AGACTCGTAACACATTCTAA -> GACTCGTAACACATTCTAAA
CTCACCTTTGCCAGGCGACG -> TCACCTTTGCCAGGCGACGC
TTCCCGGGTGTCAACGACAC -> TCCCGGGTGTCAACGACACC
CTTCCACCAGACCATCTTAG -> TTCCACCAGACCATCTTAGT
CGAGAAGAGCGAGTTTTTCA -> GAGAAGAGCGAGTTTTTCAG
CAGCTTCCACCAGACCATCT -> AGCTTCCACCAGACCATCTT
TTCTCGCGAACGGCATTATA -> TCTCGCGAACGGCATTATAT
CATGTGGCCTCTTTTAGTAT -> ATGTGGCCTCTTTTAGTATC
TGTTAAGCGCCAGCCTCTTA -> GTTAAGCGCCAGCCTCTTAC
CGACGCACTGGAATACGAGA -> GACGCACTGGAATACGAGAA
AGACAGCCTAGTCGCGGGGG -> GACAGCCTAGTCGCGGGGGC
CCAGGCGACGCACTGGAATA -> CAGGCGACGCACTGGAATAC
GAAGTCCTAAGGTGGAACAG -> AAGTCCTAAGGTGGAACAGG
CGGCATTATATCTTGCTGTT -> GGCATTATATCTTGCTGTTA
GTGTGAGTTTCTACCCTAAA -> TGTGAGTTTCTACCCTAAAT
GTTCGCCTTGAGGCTTAATT -> TTCGCCTTGAGGCTTAATTC
ATCCCCGAAGTCCTAAGGTG -> TCCCCGAAGTCCTAAGGTGG
CGACACCTCCATTTAGCTTA -> GACACCTCCATTTAGCTTAT
ATGGAGTTAGTTACACCCGC -> TGGAGTTAGTTACACCCGCG
CCGATGCTTGAGCTAGTGAG -> CGATGCTTGAGCTAGTGAGA
GTGAGAAAAATTCTGTTTGA -> TGAGAAAAATTCTGTTTGAC
GAACAGGTCGACGTGAAAAT -> AACAGGTCGACGTGAAAATA
GCGAACGGCATTATATCTTG -> CGAACGGCATTATATCTTGC
AAATAAAGAAGGTTAGGAGT -> AATAAAGAAGGTTAGGAGTG
AACAGGAGGGGTCCCCGGCA -> ACAGGAGGGGTCCCCGGCAG
AAGACAGCCTAGTCGCGGGG -> AGACAGCCTAGTCGCGGGGG
ATTAGACTCGTAACACATTC -> TTAGACTCGTAACACATTCT
GGTGTCAACGACACCTCCAT -> GTGTCAACGACACCTCCATT
AGGCGACGCACTGGAATACG -> GGCGACGCACTGGAATACGA
GTAACACATTCTAAAGTACA -> TAACACATTCTAAAGTACAG
TTAAGCGAGTTACGAATGGA -> TAAGCGAGTTACGAATGGAG
TTTGACATGACCTGTCAATA -> TTGACATGACCTGTCAATAG
ATGTGGCCTCTTTTAGTATC -> TGTGGCCTCTTTTAGTATCC
AACCAAAATGCTTGACCTCT -> ACCAAAATGCTTGACCTCTA
ACGACACCTCCATTTAGCTT -> CGACACCTCCATTTAGCTTA
TTTGCCAGGCGACGCACTGG -> TTGCCAGGCGACGCACTGGA
CGCATGGCGTTCGCCTTGAG -> GCATGGCGTTCGCCTTGAGG
GTTTTTCAGCTTCCACCAGA -> TTTTTCAGCTTCCACCAGAC
GTTGCTCTCAGCTGCATGTG -> TTGCTCTCAGCTGCATGTGG
TTTTAGAGGGACATTCTACG -> TTTAGAGGGACATTCTACGA
GGAATACGAGAAGAGCGAGT -> GAATACGAGAAGAGCGAGTT
ATAGAGCCATTCTAACCATC -> TAGAGCCATTCTAACCATCT
TTCGCCTTGAGGCTTAATTC -> TCGCCTTGAGGCTTAATTCC
AGAAGGTTAGGAGTGTTAAA -> GAAGGTTAGGAGTGTTAAAG
GGACATTCTACGAGAAACAA -> GACATTCTACGAGAAACAAC
ATCCCCATTTCCCGGGTGTC -> TCCCCATTTCCCGGGTGTCA
GACCATCTTAGTATTGCCGC -> ACCATCTTAGTATTGCCGCC
CAGTTCCGGATTGCCCTCAC -> AGTTCCGGATTGCCCTCACC
GTCAAACAGGAGGGGTCCCC -> TCAAACAGGAGGGGTCCCCG
AATGCTAAGCTACGGGATGC -> ATGCTAAGCTACGGGATGCC
CTTGAGCTAGTGAGAAAAAT -> TTGAGCTAGTGAGAAAAATT
AAGCGCCAGCCTCTTACTTT -> AGCGCCAGCCTCTTACTTTA
TTTGAAACGGTAAGTCGCCG -> TTGAAACGGTAAGTCGCCGA
TCCATTTAGCTTATGCGGTT -> CCATTTAGCTTATGCGGTTA
ATTAATTTGAAACGGTAAGT -> TTAATTTGAAACGGTAAGTC
AGACCAGTTCCGGATTGCCC -> GACCAGTTCCGGATTGCCCT
ATAAACATGTAACCAAAATG -> TAAACATGTAACCAAAATGC
CTTGACGATGAAGCATTAAC -> TTGACGATGAAGCATTAACA
CTTTAACGAATTGCAGACCG -> TTTAACGAATTGCAGACCGC
GATGCCCCGAAATCATGAGA -> ATGCCCCGAAATCATGAGAA
TTAATTCCTCACGTAATATT -> TAATTCCTCACGTAATATTA
ACTTTAACGAATTGCAGACC -> CTTTAACGAATTGCAGACCG
TGACCTGTCAATAGGCGCAC -> GACCTGTCAATAGGCGCACT
TACGGGATGCCCCGAAATCA -> ACGGGATGCCCCGAAATCAT
GCATTAACAGTTAAGGTACT -> CATTAACAGTTAAGGTACTA
TGTTTGACATGACCTGTCAA -> GTTTGACATGACCTGTCAAT
TTATGCGGTTATTCTCGCGA -> TATGCGGTTATTCTCGCGAA
GCGGTTATTCTCGCGAACGG -> CGGTTATTCTCGCGAACGGC
GGTCCCCGGCAGGTTGCTCT -> GTCCCCGGCAGGTTGCTCTC
AATAGGCGCACTTTTAGAGG -> ATAGGCGCACTTTTAGAGGG
TGGGTAGCAACCGGCTTACT -> GGGTAGCAACCGGCTTACTA
CAGCCTCTTACTTTACTTCA -> AGCCTCTTACTTTACTTCAC
TGTGAGTTTCTACCCTAAAT -> GTGAGTTTCTACCCTAAATA
AGTTAAGGTACTATAGAGCC -> GTTAAGGTACTATAGAGCCA
GTAATATTAACCCAGTAATG -> TAATATTAACCCAGTAATGC
AACGGCATTATATCTTGCTG -> ACGGCATTATATCTTGCTGT
CCATTCTAACCATCTAAGTT -> CATTCTAACCATCTAAGTTA
TTCTGTTTGACATGACCTGT -> TCTGTTTGACATGACCTGTC
GCGCACTTTTAGAGGGACAT -> CGCACTTTTAGAGGGACATT
AGACTTTAACGAATTGCAGA -> GACTTTAACGAATTGCAGAC
TCGCCGATGCTTGAGCTAGT -> CGCCGATGCTTGAGCTAGTG
GAGTGTTAAAGTTCCTAGAC -> AGTGTTAAAGTTCCTAGACC
AGCATGCGATTAATTTGAAA -> GCATGCGATTAATTTGAAAC
GCCCTCACCTTTGCCAGGCG -> CCCTCACCTTTGCCAGGCGA
TTCCACCAGACCATCTTAGT -> TCCACCAGACCATCTTAGTA
AAATCATGAGAATGACTTGC -> AATCATGAGAATGACTTGCA
GGATGCCCCGAAATCATGAG -> GATGCCCCGAAATCATGAGA
ACACCTCCATTTAGCTTATG -> CACCTCCATTTAGCTTATGC
TGCTCTCAGCTGCATGTGGC -> GCTCTCAGCTGCATGTGGCC
ATTCTCGCGAACGGCATTAT -> TTCTCGCGAACGGCATTATA
ATGACCTGTCAATAGGCGCA -> TGACCTGTCAATAGGCGCAC
CTTATGCGGTTATTCTCGCG -> TTATGCGGTTATTCTCGCGA
TAATTCCTCACGTAATATTA -> AATTCCTCACGTAATATTAA
GATGAAGCATTAACAGTTAA -> ATGAAGCATTAACAGTTAAG
CGCCCTTCCTGACAGAATTT -> GCCCTTCCTGACAGAATTTC
TGCTGTTAAGCGCCAGCCTC -> GCTGTTAAGCGCCAGCCTCT
CATGGCGTTCGCCTTGAGGC -> ATGGCGTTCGCCTTGAGGCT
AAAAATTCTGTTTGACATGA -> AAAATTCTGTTTGACATGAC
CGCCCGAGAGAGTCGTACCT -> GCCCGAGAGAGTCGTACCTG
GAGCCATTCTAACCATCTAA -> AGCCATTCTAACCATCTAAG
TGACGATGAAGCATTAACAG -> GACGATGAAGCATTAACAGT
CAACCCGCCCTTCCTGACAG -> AACCCGCCCTTCCTGACAGA
CAGACCAGTTCCGGATTGCC -> AGACCAGTTCCGGATTGCCC
GCTCTCAGCTGCATGTGGCC -> CTCTCAGCTGCATGTGGCCT
GCGTCAAACAGGAGGGGTCC -> CGTCAAACAGGAGGGGTCCC
CCCGGCAGGTTGCTCTCAGC -> CCGGCAGGTTGCTCTCAGCT
CCCGAAATCATGAGAATGAC -> CCGAAATCATGAGAATGACT
TAAGCTACGGGATGCCCCGA -> AAGCTACGGGATGCCCCGAA
GCCGCCGGCTAGTACACTTG -> CCGCCGGCTAGTACACTTGA
CGGTTATTCTCGCGAACGGC -> GGTTATTCTCGCGAACGGCA
GAGTTAGTTACACCCGCGCC -> AGTTAGTTACACCCGCGCCC
GACCGCGCTATCCCCATTTC -> ACCGCGCTATCCCCATTTCC
TCCTGACAGAATTTCAAAAT -> CCTGACAGAATTTCAAAATC
GATTAATTTGAAACGGTAAG -> ATTAATTTGAAACGGTAAGT
AGTTAGTTACACCCGCGCCC -> GTTAGTTACACCCGCGCCCC
AATGACTTGCAGCGTCATCC -> ATGACTTGCAGCGTCATCCC
ACCCCGGTAGGATACAGGGG -> CCCCGGTAGGATACAGGGGC
CGCGCCCCTACCTGGATCTC -> GCGCCCCTACCTGGATCTCG
ATCTCGCATCGCAACAAGAC -> TCTCGCATCGCAACAAGACA
TAGACCCCGGTAGGATACAG -> AGACCCCGGTAGGATACAGG
CCACCAGACCATCTTAGTAT -> CACCAGACCATCTTAGTATT
AACGAATTGCAGACCGCGCT -> ACGAATTGCAGACCGCGCTA
TGCGATTAATTTGAAACGGT -> GCGATTAATTTGAAACGGTA
ACTATAGAGCCATTCTAACC -> CTATAGAGCCATTCTAACCA
GGAGGGGTCCCCGGCAGGTT -> GAGGGGTCCCCGGCAGGTTG
AGACCCCGGTAGGATACAGG -> GACCCCGGTAGGATACAGGG
AGCGAGTTTTTCAGCTTCCA -> GCGAGTTTTTCAGCTTCCAC
AGTCATTTAGACTTTAACGA -> GTCATTTAGACTTTAACGAA
CGGGATGCCCCGAAATCATG -> GGGATGCCCCGAAATCATGA
AATATTAACCCAGTAATGCT -> ATATTAACCCAGTAATGCTA
ACCGGCTTACTATTGATTTC -> CCGGCTTACTATTGATTTCT
CTGTTTGACATGACCTGTCA -> TGTTTGACATGACCTGTCAA
CAGGGGCAAGCATGCGATTA -> AGGGGCAAGCATGCGATTAA
AGGGGTCCCCGGCAGGTTGC -> GGGGTCCCCGGCAGGTTGCT
ACGCGGGCCATCTGCGCACG -> CGCGGGCCATCTGCGCACGA
CCCGCCCTTCCTGACAGAAT -> CCGCCCTTCCTGACAGAATT
TATCTTGCTGTTAAGCGCCA -> ATCTTGCTGTTAAGCGCCAG
TTGGGTAGCAACCGGCTTAC -> TGGGTAGCAACCGGCTTACT
TGTATCGCCCGAGAGAGTCG -> GTATCGCCCGAGAGAGTCGT
CGGTAGGATACAGGGGCAAG -> GGTAGGATACAGGGGCAAGC
GATACAGGGGCAAGCATGCG -> ATACAGGGGCAAGCATGCGA
GTTAAAGTTCCTAGACCCCG -> TTAAAGTTCCTAGACCCCGG
TCCTAAGGTGGAACAGGTCG -> CCTAAGGTGGAACAGGTCGA
GACTCGTAACACATTCTAAA -> ACTCGTAACACATTCTAAAG
GGTAAGTCGCCGATGCTTGA -> GTAAGTCGCCGATGCTTGAG
TTTTTCAGCTTCCACCAGAC -> TTTTCAGCTTCCACCAGACC
TAAGGTACTATAGAGCCATT -> AAGGTACTATAGAGCCATTC
AGCGAGTTACGAATGGAGTT -> GCGAGTTACGAATGGAGTTA
AGGCTTAATTCCTCACGTAA -> GGCTTAATTCCTCACGTAAT
TTAATTTGAAACGGTAAGTC -> TAATTTGAAACGGTAAGTCG
ATGGCGTTCGCCTTGAGGCT -> TGGCGTTCGCCTTGAGGCTT
TTCAAAATCGCAGGAACGGA -> TCAAAATCGCAGGAACGGAG
AGGTTAGGAGTGTTAAAGTT -> GGTTAGGAGTGTTAAAGTTC
AGTGTTAAAGTTCCTAGACC -> GTGTTAAAGTTCCTAGACCC
TATTCTCGCGAACGGCATTA -> ATTCTCGCGAACGGCATTAT
CTATTGGGTAGCAACCGGCT -> TATTGGGTAGCAACCGGCTT
ATGCTTGACCTCTATTGGGT -> TGCTTGACCTCTATTGGGTA
CTTAATTCCTCACGTAATAT -> TTAATTCCTCACGTAATATT
ATATTAACCCAGTAATGCTA -> TATTAACCCAGTAATGCTAA
ACGCATGGCGTTCGCCTTGA -> CGCATGGCGTTCGCCTTGAG
CCAGTAATGCTAAGCTACGG -> CAGTAATGCTAAGCTACGGG
ACCCGCGCCCCTACCTGGAT -> CCCGCGCCCCTACCTGGATC
AGGGACATTCTACGAGAAAC -> GGGACATTCTACGAGAAACA
CGGATTGCCCTCACCTTTGC -> GGATTGCCCTCACCTTTGCC
CAAGCATGCGATTAATTTGA -> AAGCATGCGATTAATTTGAA
GAATTGCAGACCGCGCTATC -> AATTGCAGACCGCGCTATCC
GAATGACTTGCAGCGTCATC -> AATGACTTGCAGCGTCATCC
AGCGTCATCCCCGAAGTCCT -> GCGTCATCCCCGAAGTCCTA
GAGGCTTAATTCCTCACGTA -> AGGCTTAATTCCTCACGTAA
GCCAGCCTCTTACTTTACTT -> CCAGCCTCTTACTTTACTTC
CCTCACGTAATATTAACCCA -> CTCACGTAATATTAACCCAG
CCCCGGTAGGATACAGGGGC -> CCCGGTAGGATACAGGGGCA
AGAATGACTTGCAGCGTCAT -> GAATGACTTGCAGCGTCATC
TCGCGAACGGCATTATATCT -> CGCGAACGGCATTATATCTT
TCACGTAATATTAACCCAGT -> CACGTAATATTAACCCAGTA
CAAAATGCTTGACCTCTATT -> AAAATGCTTGACCTCTATTG
GCTAGTGAGAAAAATTCTGT -> CTAGTGAGAAAAATTCTGTT
ATGCTAAGCTACGGGATGCC -> TGCTAAGCTACGGGATGCCC
CGAAGTCCTAAGGTGGAACA -> GAAGTCCTAAGGTGGAACAG
GCATGCGATTAATTTGAAAC -> CATGCGATTAATTTGAAACG
AAGGTACTATAGAGCCATTC -> AGGTACTATAGAGCCATTCT
GTCCTAAGGTGGAACAGGTC -> TCCTAAGGTGGAACAGGTCG
CCTACCTGGATCTCGCATCG -> CTACCTGGATCTCGCATCGC
TATATCTTGCTGTTAAGCGC -> ATATCTTGCTGTTAAGCGCC
CTCTATTGGGTAGCAACCGG -> TCTATTGGGTAGCAACCGGC
CAACAAGACAGCCTAGTCGC -> AACAAGACAGCCTAGTCGCG
CTCGCGAACGGCATTATATC -> TCGCGAACGGCATTATATCT
TGACTTGCAGCGTCATCCCC -> GACTTGCAGCGTCATCCCCG
TTGAAACGGTAAGTCGCCGA -> TGAAACGGTAAGTCGCCGAT
CATTTAGACTTTAACGAATT -> ATTTAGACTTTAACGAATTG
CTTTTAGAGGGACATTCTAC -> TTTTAGAGGGACATTCTACG
TAACCAAAATGCTTGACCTC -> AACCAAAATGCTTGACCTCT
TAGACTTTAACGAATTGCAG -> AGACTTTAACGAATTGCAGA
CATTAAGCGAGTTACGAATG -> ATTAAGCGAGTTACGAATGG
GGCGACGCACTGGAATACGA -> GCGACGCACTGGAATACGAG
CATGACCTGTCAATAGGCGC -> ATGACCTGTCAATAGGCGCA
TATAGAGCCATTCTAACCAT -> ATAGAGCCATTCTAACCATC
TCTTACTTTACTTCACTACG -> CTTACTTTACTTCACTACGC
ATGCTTGAGCTAGTGAGAAA -> TGCTTGAGCTAGTGAGAAAA
CTACGCATGGCGTTCGCCTT -> TACGCATGGCGTTCGCCTTG
GCACTTTTAGAGGGACATTC -> CACTTTTAGAGGGACATTCT
GGAGTGTTAAAGTTCCTAGA -> GAGTGTTAAAGTTCCTAGAC
TTCTAAAGTACAGACCAGTT -> TCTAAAGTACAGACCAGTTC
CAGCTGCATGTGGCCTCTTT -> AGCTGCATGTGGCCTCTTTT
TGCTTGACCTCTATTGGGTA -> GCTTGACCTCTATTGGGTAG
ACAGGGGCAAGCATGCGATT -> CAGGGGCAAGCATGCGATTA
TAACGAATTGCAGACCGCGC -> AACGAATTGCAGACCGCGCT
TTAGTGTGACTATGTTTAGT -> TAGTGTGACTATGTTTAGTG
GGTTATTCTCGCGAACGGCA -> GTTATTCTCGCGAACGGCAT
AGCGTCAAACAGGAGGGGTC -> GCGTCAAACAGGAGGGGTCC
GAGTTACGAATGGAGTTAGT -> AGTTACGAATGGAGTTAGTT
CCTCTTACTTTACTTCACTA -> CTCTTACTTTACTTCACTAC
GCCTAGTCGCGGGGGCTGTA -> CCTAGTCGCGGGGGCTGTAT
GGGCAAGCATGCGATTAATT -> GGCAAGCATGCGATTAATTT
TAGAGGGACATTCTACGAGA -> AGAGGGACATTCTACGAGAA
GATTAGACTCGTAACACATT -> ATTAGACTCGTAACACATTC
ACTTGCAGCGTCATCCCCGA -> CTTGCAGCGTCATCCCCGAA
TATTGCCGCCGGCTAGTACA -> ATTGCCGCCGGCTAGTACAC
GACTATGTTTAGTGTGAGTT -> ACTATGTTTAGTGTGAGTTT
ACCAGACCATCTTAGTATTG -> CCAGACCATCTTAGTATTGC
TAATGCTAAGCTACGGGATG -> AATGCTAAGCTACGGGATGC
ACACTTGACGATGAAGCATT -> CACTTGACGATGAAGCATTA
TCTAACCATCTAAGTTAGTG -> CTAACCATCTAAGTTAGTGT
TCTCGCGAACGGCATTATAT -> CTCGCGAACGGCATTATATC
TTTTAGTATCCACCATGATT -> TTTAGTATCCACCATGATTA
CCGAGAGAGTCGTACCTGGC -> CGAGAGAGTCGTACCTGGCA
ATTAACAGTTAAGGTACTAT -> TTAACAGTTAAGGTACTATA
CTTCACTACGCATGGCGTTC -> TTCACTACGCATGGCGTTCG
CTGGATCTCGCATCGCAACA -> TGGATCTCGCATCGCAACAA
CATCGCAACAAGACAGCCTA -> ATCGCAACAAGACAGCCTAG
TGAGTTTCTACCCTAAATAA -> GAGTTTCTACCCTAAATAAA
TCGCCCGAGAGAGTCGTACC -> CGCCCGAGAGAGTCGTACCT
AAATTCTGTTTGACATGACC -> AATTCTGTTTGACATGACCT
AGGTGGAACAGGTCGACGTG -> GGTGGAACAGGTCGACGTGA
ATTGCCGCCGGCTAGTACAC -> TTGCCGCCGGCTAGTACACT
AACGACACCTCCATTTAGCT -> ACGACACCTCCATTTAGCTT
GTTAAGGTACTATAGAGCCA -> TTAAGGTACTATAGAGCCAT
CATTTCCCGGGTGTCAACGA -> ATTTCCCGGGTGTCAACGAC
CGCCCCTACCTGGATCTCGC -> GCCCCTACCTGGATCTCGCA
GAATGGAGTTAGTTACACCC -> AATGGAGTTAGTTACACCCG
GGCCATCTGCGCACGAAGGA -> GCCATCTGCGCACGAAGGAC
GACGATGAAGCATTAACAGT -> ACGATGAAGCATTAACAGTT
TTAAAGTTCCTAGACCCCGG -> TAAAGTTCCTAGACCCCGGT
AGTCGTACCTGGCAACCCGC -> GTCGTACCTGGCAACCCGCC
CCATTTCCCGGGTGTCAACG -> CATTTCCCGGGTGTCAACGA
CTGTATCGCCCGAGAGAGTC -> TGTATCGCCCGAGAGAGTCG
GTTACACCCGCGCCCCTACC -> TTACACCCGCGCCCCTACCT
AGAAGAGCGAGTTTTTCAGC -> GAAGAGCGAGTTTTTCAGCT
AAGTTCCTAGACCCCGGTAG -> AGTTCCTAGACCCCGGTAGG
CACCAGACCATCTTAGTATT -> ACCAGACCATCTTAGTATTG
CAGACCATCTTAGTATTGCC -> AGACCATCTTAGTATTGCCG
TCGCGGGGGCTGTATCGCCC -> CGCGGGGGCTGTATCGCCCG
ACATTCTACGAGAAACAACA -> CATTCTACGAGAAACAACAT
AAGGTTAGGAGTGTTAAAGT -> AGGTTAGGAGTGTTAAAGTT
GATCTCGCATCGCAACAAGA -> ATCTCGCATCGCAACAAGAC
GCGCACGAAGGACGTATCAG -> CGCACGAAGGACGTATCAGT
GTTATTCTCGCGAACGGCAT -> TTATTCTCGCGAACGGCATT
ATTAACCCAGTAATGCTAAG -> TTAACCCAGTAATGCTAAGC
TTACGAATGGAGTTAGTTAC -> TACGAATGGAGTTAGTTACA
ACGTATCAGTCATTTAGACT -> CGTATCAGTCATTTAGACTT
TCTTTTAGTATCCACCATGA -> CTTTTAGTATCCACCATGAT
GCCGATGCTTGAGCTAGTGA -> CCGATGCTTGAGCTAGTGAG
ACTTCACTACGCATGGCGTT -> CTTCACTACGCATGGCGTTC
AACAAGACAGCCTAGTCGCG -> ACAAGACAGCCTAGTCGCGG
TTCCTAGACCCCGGTAGGAT -> TCCTAGACCCCGGTAGGATA
TCGTACCTGGCAACCCGCCC -> CGTACCTGGCAACCCGCCCT
CCCTAAATAAACATGTAACC -> CCTAAATAAACATGTAACCA
TCTATTGGGTAGCAACCGGC -> CTATTGGGTAGCAACCGGCT
TTACTTCACTACGCATGGCG -> TACTTCACTACGCATGGCGT
GAAAATAAAGAAGGTTAGGA -> AAAATAAAGAAGGTTAGGAG
GACCTCTATTGGGTAGCAAC -> ACCTCTATTGGGTAGCAACC
CGAGTTACGAATGGAGTTAG -> GAGTTACGAATGGAGTTAGT
TCGACGTGAAAATAAAGAAG -> CGACGTGAAAATAAAGAAGG
ATTTCCCGGGTGTCAACGAC -> TTTCCCGGGTGTCAACGACA
ATGCGGTTATTCTCGCGAAC -> TGCGGTTATTCTCGCGAACG
GTCAATAGGCGCACTTTTAG -> TCAATAGGCGCACTTTTAGA
CATGTAACCAAAATGCTTGA -> ATGTAACCAAAATGCTTGAC
AGCTTATGCGGTTATTCTCG -> GCTTATGCGGTTATTCTCGC
ACGAATTGCAGACCGCGCTA -> CGAATTGCAGACCGCGCTAT
CACGTAATATTAACCCAGTA -> ACGTAATATTAACCCAGTAA
TTAGCTTATGCGGTTATTCT -> TAGCTTATGCGGTTATTCTC
TGGAGTTAGTTACACCCGCG -> GGAGTTAGTTACACCCGCGC
CAAAATCGCAGGAACGGAGC -> AAAATCGCAGGAACGGAGCG
GACTTGCAGCGTCATCCCCG -> ACTTGCAGCGTCATCCCCGA
AGCAACCGGCTTACTATTGA -> GCAACCGGCTTACTATTGAT
GTGTCAACGACACCTCCATT -> TGTCAACGACACCTCCATTT
ACAGGTCGACGTGAAAATAA -> CAGGTCGACGTGAAAATAAA
TATTGGGTAGCAACCGGCTT -> ATTGGGTAGCAACCGGCTTA
ATTGCAGACCGCGCTATCCC -> TTGCAGACCGCGCTATCCCC
ATGCGATTAATTTGAAACGG -> TGCGATTAATTTGAAACGGT
AGAGGGACATTCTACGAGAA -> GAGGGACATTCTACGAGAAA
AAGAGCGAGTTTTTCAGCTT -> AGAGCGAGTTTTTCAGCTTC
GAGTTTCTACCCTAAATAAA -> AGTTTCTACCCTAAATAAAC
GTTAAGCGCCAGCCTCTTAC -> TTAAGCGCCAGCCTCTTACT
GCCATCTGCGCACGAAGGAC -> CCATCTGCGCACGAAGGACG
CTATCCCCATTTCCCGGGTG -> TATCCCCATTTCCCGGGTGT
TTTCAAAATCGCAGGAACGG -> TTCAAAATCGCAGGAACGGA
AAGCATTAACAGTTAAGGTA -> AGCATTAACAGTTAAGGTAC
TTCTACCCTAAATAAACATG -> TCTACCCTAAATAAACATGT
GAAGCATTAACAGTTAAGGT -> AAGCATTAACAGTTAAGGTA
TATCGCCCGAGAGAGTCGTA -> ATCGCCCGAGAGAGTCGTAC
AATACGAGAAGAGCGAGTTT -> ATACGAGAAGAGCGAGTTTT
CCCCGGCAGGTTGCTCTCAG -> CCCGGCAGGTTGCTCTCAGC
ACCATCTTAGTATTGCCGCC -> CCATCTTAGTATTGCCGCCG
TTTAGTGTGAGTTTCTACCC -> TTAGTGTGAGTTTCTACCCT
CAGGTTGCTCTCAGCTGCAT -> AGGTTGCTCTCAGCTGCATG
CTAGTCGCGGGGGCTGTATC -> TAGTCGCGGGGGCTGTATCG
CTTACTTTACTTCACTACGC -> TTACTTTACTTCACTACGCA
CACTACGCATGGCGTTCGCC -> ACTACGCATGGCGTTCGCCT
CATTCTACGAGAAACAACAT -> ATTCTACGAGAAACAACATT
GTTAGGAGTGTTAAAGTTCC -> TTAGGAGTGTTAAAGTTCCT
CCCATTTCCCGGGTGTCAAC -> CCATTTCCCGGGTGTCAACG
AGCCTCTTACTTTACTTCAC -> GCCTCTTACTTTACTTCACT
TGAAAATAAAGAAGGTTAGG -> GAAAATAAAGAAGGTTAGGA
TTGACCTCTATTGGGTAGCA -> TGACCTCTATTGGGTAGCAA
TTGCTCTCAGCTGCATGTGG -> TGCTCTCAGCTGCATGTGGC
CACCTTTGCCAGGCGACGCA -> ACCTTTGCCAGGCGACGCAC
AGCTTCCACCAGACCATCTT -> GCTTCCACCAGACCATCTTA
TAATTTGAAACGGTAAGTCG -> AATTTGAAACGGTAAGTCGC
ATTAAGCGAGTTACGAATGG -> TTAAGCGAGTTACGAATGGA
CGACGTGAAAATAAAGAAGG -> GACGTGAAAATAAAGAAGGT
CGCCGGCTAGTACACTTGAC -> GCCGGCTAGTACACTTGACG
GAGCGAGTTTTTCAGCTTCC -> AGCGAGTTTTTCAGCTTCCA
TCCCCGGCAGGTTGCTCTCA -> CCCCGGCAGGTTGCTCTCAG
GTTCCGGATTGCCCTCACCT -> TTCCGGATTGCCCTCACCTT
TCACTACGCATGGCGTTCGC -> CACTACGCATGGCGTTCGCC
CTAGTACACTTGACGATGAA -> TAGTACACTTGACGATGAAG
CGCATCGCAACAAGACAGCC -> GCATCGCAACAAGACAGCCT
GCATCGCAACAAGACAGCCT -> CATCGCAACAAGACAGCCTA
GGGGCAAGCATGCGATTAAT -> GGGCAAGCATGCGATTAATT
GAAGGACGTATCAGTCATTT -> AAGGACGTATCAGTCATTTA
TAACACATTCTAAAGTACAG -> AACACATTCTAAAGTACAGA
TACGCATGGCGTTCGCCTTG -> ACGCATGGCGTTCGCCTTGA
TACTTCACTACGCATGGCGT -> ACTTCACTACGCATGGCGTT
TGAAACGGTAAGTCGCCGAT -> GAAACGGTAAGTCGCCGATG
AACAACATTAAGCGAGTTAC -> ACAACATTAAGCGAGTTACG
TGCAGCGTCATCCCCGAAGT -> GCAGCGTCATCCCCGAAGTC
TAACCCAGTAATGCTAAGCT -> AACCCAGTAATGCTAAGCTA
CCCGGGTGTCAACGACACCT -> CCGGGTGTCAACGACACCTC
GTTAGTTACACCCGCGCCCC -> TTAGTTACACCCGCGCCCCT
TTACACCCGCGCCCCTACCT -> TACACCCGCGCCCCTACCTG
GCCCCTACCTGGATCTCGCA -> CCCCTACCTGGATCTCGCAT
AAGGTGGAACAGGTCGACGT -> AGGTGGAACAGGTCGACGTG
GGCAGGTTGCTCTCAGCTGC -> GCAGGTTGCTCTCAGCTGCA
CTCTCAGCTGCATGTGGCCT -> TCTCAGCTGCATGTGGCCTC
CAAGACAGCCTAGTCGCGGG -> AAGACAGCCTAGTCGCGGGG
ATGAAGCATTAACAGTTAAG -> TGAAGCATTAACAGTTAAGG
CATTATATCTTGCTGTTAAG -> ATTATATCTTGCTGTTAAGC
CATTCTAACCATCTAAGTTA -> ATTCTAACCATCTAAGTTAG
CACCCGCGCCCCTACCTGGA -> ACCCGCGCCCCTACCTGGAT
GCAACAAGACAGCCTAGTCG -> CAACAAGACAGCCTAGTCGC
AACATGTAACCAAAATGCTT -> ACATGTAACCAAAATGCTTG
TTAAGCGCCAGCCTCTTACT -> TAAGCGCCAGCCTCTTACTT
ACTTGACGATGAAGCATTAA -> CTTGACGATGAAGCATTAAC
AGGATACAGGGGCAAGCATG -> GGATACAGGGGCAAGCATGC
AGCATTAACAGTTAAGGTAC -> GCATTAACAGTTAAGGTACT
ATTCTACGAGAAACAACATT -> TTCTACGAGAAACAACATTA
CTAAAGTACAGACCAGTTCC -> TAAAGTACAGACCAGTTCCG
TCATCCCCGAAGTCCTAAGG -> CATCCCCGAAGTCCTAAGGT
TAGCAACCGGCTTACTATTG -> AGCAACCGGCTTACTATTGA
GAGTTTTTCAGCTTCCACCA -> AGTTTTTCAGCTTCCACCAG
TGCATGTGGCCTCTTTTAGT -> GCATGTGGCCTCTTTTAGTA
CGGTAAGTCGCCGATGCTTG -> GGTAAGTCGCCGATGCTTGA
AGTTACGAATGGAGTTAGTT -> GTTACGAATGGAGTTAGTTA
CGCCAGCCTCTTACTTTACT -> GCCAGCCTCTTACTTTACTT
AACCCAGTAATGCTAAGCTA -> ACCCAGTAATGCTAAGCTAC
ATTCTAACCATCTAAGTTAG -> TTCTAACCATCTAAGTTAGT
AGCGCCAGCCTCTTACTTTA -> GCGCCAGCCTCTTACTTTAC
TCGCAACAAGACAGCCTAGT -> CGCAACAAGACAGCCTAGTC
TCTAAAGTACAGACCAGTTC -> CTAAAGTACAGACCAGTTCC
ACCTCCATTTAGCTTATGCG -> CCTCCATTTAGCTTATGCGG
TTAGACTTTAACGAATTGCA -> TAGACTTTAACGAATTGCAG
ACCTGGATCTCGCATCGCAA -> CCTGGATCTCGCATCGCAAC
TACGAGAAACAACATTAAGC -> ACGAGAAACAACATTAAGCG
TTAACGAATTGCAGACCGCG -> TAACGAATTGCAGACCGCGC
GGTGGAACAGGTCGACGTGA -> GTGGAACAGGTCGACGTGAA
CGCTATCCCCATTTCCCGGG -> GCTATCCCCATTTCCCGGGT
GTGTTAAAGTTCCTAGACCC -> TGTTAAAGTTCCTAGACCCC
AATTGCAGACCGCGCTATCC -> ATTGCAGACCGCGCTATCCC
TGCTTGAGCTAGTGAGAAAA -> GCTTGAGCTAGTGAGAAAAA
TAAGGTGGAACAGGTCGACG -> AAGGTGGAACAGGTCGACGT
TCTCGCATCGCAACAAGACA -> CTCGCATCGCAACAAGACAG
AAATGCTTGACCTCTATTGG -> AATGCTTGACCTCTATTGGG
ATCCACCATGATTAGACTCG -> TCCACCATGATTAGACTCGT
AGTCGCCGATGCTTGAGCTA -> GTCGCCGATGCTTGAGCTAG
TATCAGTCATTTAGACTTTA -> ATCAGTCATTTAGACTTTAA
TCTTAGTATTGCCGCCGGCT -> CTTAGTATTGCCGCCGGCTA
ATACAGGGGCAAGCATGCGA -> TACAGGGGCAAGCATGCGAT
GCGACGCACTGGAATACGAG -> CGACGCACTGGAATACGAGA
AAGAAGGTTAGGAGTGTTAA -> AGAAGGTTAGGAGTGTTAAA
GTATCGCCCGAGAGAGTCGT -> TATCGCCCGAGAGAGTCGTA
CGGGCCATCTGCGCACGAAG -> GGGCCATCTGCGCACGAAGG
AATCATGAGAATGACTTGCA -> ATCATGAGAATGACTTGCAG
TAACCATCTAAGTTAGTGTG -> AACCATCTAAGTTAGTGTGA
GGTTGCTCTCAGCTGCATGT -> GTTGCTCTCAGCTGCATGTG
ACCCGCCCTTCCTGACAGAA -> CCCGCCCTTCCTGACAGAAT
GGATCTCGCATCGCAACAAG -> GATCTCGCATCGCAACAAGA
GCCCCGAAATCATGAGAATG -> CCCCGAAATCATGAGAATGA
AAATAAACATGTAACCAAAA -> AATAAACATGTAACCAAAAT
AGGCGCACTTTTAGAGGGAC -> GGCGCACTTTTAGAGGGACA
ATTTGAAACGGTAAGTCGCC -> TTTGAAACGGTAAGTCGCCG
GTTCCTAGACCCCGGTAGGA -> TTCCTAGACCCCGGTAGGAT
TGCAGACCGCGCTATCCCCA -> GCAGACCGCGCTATCCCCAT
TTATATCTTGCTGTTAAGCG -> TATATCTTGCTGTTAAGCGC
TATCCCCATTTCCCGGGTGT -> ATCCCCATTTCCCGGGTGTC
GAGCGTCAAACAGGAGGGGT -> AGCGTCAAACAGGAGGGGTC
CAGTTAAGGTACTATAGAGC -> AGTTAAGGTACTATAGAGCC
CAACATTAAGCGAGTTACGA -> AACATTAAGCGAGTTACGAA
GTAAGTCGCCGATGCTTGAG -> TAAGTCGCCGATGCTTGAGC
CCGCGCTATCCCCATTTCCC -> CGCGCTATCCCCATTTCCCG
GACAGAATTTCAAAATCGCA -> ACAGAATTTCAAAATCGCAG
ACGCACTGGAATACGAGAAG -> CGCACTGGAATACGAGAAGA
GCCTCTTTTAGTATCCACCA -> CCTCTTTTAGTATCCACCAT
TACGAGAAGAGCGAGTTTTT -> ACGAGAAGAGCGAGTTTTTC
GCTAAGCTACGGGATGCCCC -> CTAAGCTACGGGATGCCCCG
ACAACATTAAGCGAGTTACG -> CAACATTAAGCGAGTTACGA
TGGCCTCTTTTAGTATCCAC -> GGCCTCTTTTAGTATCCACC
GGGTGTCAACGACACCTCCA -> GGTGTCAACGACACCTCCAT
CGTCATCCCCGAAGTCCTAA -> GTCATCCCCGAAGTCCTAAG
TTGCAGCGTCATCCCCGAAG -> TGCAGCGTCATCCCCGAAGT
GCCATTCTAACCATCTAAGT -> CCATTCTAACCATCTAAGTT
TCCTAGACCCCGGTAGGATA -> CCTAGACCCCGGTAGGATAC
AGAAACAACATTAAGCGAGT -> GAAACAACATTAAGCGAGTT
CATGAGAATGACTTGCAGCG -> ATGAGAATGACTTGCAGCGT
TGAAGCATTAACAGTTAAGG -> GAAGCATTAACAGTTAAGGT
ACCTTTGCCAGGCGACGCAC -> CCTTTGCCAGGCGACGCACT
CCTGTCAATAGGCGCACTTT -> CTGTCAATAGGCGCACTTTT
ACGGGATGCCCCGAAATCAT -> CGGGATGCCCCGAAATCATG
TCGTAACACATTCTAAAGTA -> CGTAACACATTCTAAAGTAC
AGTTAGTGTGACTATGTTTA -> GTTAGTGTGACTATGTTTAG
TTCTACGAGAAACAACATTA -> TCTACGAGAAACAACATTAA
GGGGTCCCCGGCAGGTTGCT -> GGGTCCCCGGCAGGTTGCTC
CCATCTGCGCACGAAGGACG -> CATCTGCGCACGAAGGACGT
GGGGGCTGTATCGCCCGAGA -> GGGGCTGTATCGCCCGAGAG
CCAGCCTCTTACTTTACTTC -> CAGCCTCTTACTTTACTTCA
AGGTCGACGTGAAAATAAAG -> GGTCGACGTGAAAATAAAGA
CCACCATGATTAGACTCGTA -> CACCATGATTAGACTCGTAA
TACTATAGAGCCATTCTAAC -> ACTATAGAGCCATTCTAACC
ACGGAGCGTCAAACAGGAGG -> CGGAGCGTCAAACAGGAGGG
GTGGCCTCTTTTAGTATCCA -> TGGCCTCTTTTAGTATCCAC
ATCATGAGAATGACTTGCAG -> TCATGAGAATGACTTGCAGC
AGTTACACCCGCGCCCCTAC -> GTTACACCCGCGCCCCTACC
AAGCGAGTTACGAATGGAGT -> AGCGAGTTACGAATGGAGTT
ACTACGCATGGCGTTCGCCT -> CTACGCATGGCGTTCGCCTT
GAATTTCAAAATCGCAGGAA -> AATTTCAAAATCGCAGGAAC
CACCTCCATTTAGCTTATGC -> ACCTCCATTTAGCTTATGCG
GGGTCCCCGGCAGGTTGCTC -> GGTCCCCGGCAGGTTGCTCT
GAAACGGTAAGTCGCCGATG -> AAACGGTAAGTCGCCGATGC
TTTAGACTTTAACGAATTGC -> TTAGACTTTAACGAATTGCA
ATTTAGCTTATGCGGTTATT -> TTTAGCTTATGCGGTTATTC
GCGTCATCCCCGAAGTCCTA -> CGTCATCCCCGAAGTCCTAA
AATTTGAAACGGTAAGTCGC -> ATTTGAAACGGTAAGTCGCC
CACTTTTAGAGGGACATTCT -> ACTTTTAGAGGGACATTCTA
GAACGGCATTATATCTTGCT -> AACGGCATTATATCTTGCTG
ACAGACCAGTTCCGGATTGC -> CAGACCAGTTCCGGATTGCC
ACGAAGGACGTATCAGTCAT -> CGAAGGACGTATCAGTCATT
AATGCTTGACCTCTATTGGG -> ATGCTTGACCTCTATTGGGT
TGCCGCCGGCTAGTACACTT -> GCCGCCGGCTAGTACACTTG
AAACAGGAGGGGTCCCCGGC -> AACAGGAGGGGTCCCCGGCA
ATGCCCCGAAATCATGAGAA -> TGCCCCGAAATCATGAGAAT
ACGGTAAGTCGCCGATGCTT -> CGGTAAGTCGCCGATGCTTG
TAGGAGTGTTAAAGTTCCTA -> AGGAGTGTTAAAGTTCCTAG
ATATCTTGCTGTTAAGCGCC -> TATCTTGCTGTTAAGCGCCA
ATCTGCGCACGAAGGACGTA -> TCTGCGCACGAAGGACGTAT
TCGCCTTGAGGCTTAATTCC -> CGCCTTGAGGCTTAATTCCT
CGCCGATGCTTGAGCTAGTG -> GCCGATGCTTGAGCTAGTGA
CTGACAGAATTTCAAAATCG -> TGACAGAATTTCAAAATCGC
CCGAAGTCCTAAGGTGGAAC -> CGAAGTCCTAAGGTGGAACA
GGCAAGCATGCGATTAATTT -> GCAAGCATGCGATTAATTTG
GAAATCATGAGAATGACTTG -> AAATCATGAGAATGACTTGC
GAAAAATTCTGTTTGACATG -> AAAAATTCTGTTTGACATGA
CCGAAATCATGAGAATGACT -> CGAAATCATGAGAATGACTT
TGAGGCTTAATTCCTCACGT -> GAGGCTTAATTCCTCACGTA
TTAGACTCGTAACACATTCT -> TAGACTCGTAACACATTCTA
AGTGAGAAAAATTCTGTTTG -> GTGAGAAAAATTCTGTTTGA
GTTACGAATGGAGTTAGTTA -> TTACGAATGGAGTTAGTTAC
CCTGGATCTCGCATCGCAAC -> CTGGATCTCGCATCGCAACA
CGCACTGGAATACGAGAAGA -> GCACTGGAATACGAGAAGAG
CGGGGGCTGTATCGCCCGAG -> GGGGGCTGTATCGCCCGAGA
GGTCGACGTGAAAATAAAGA -> GTCGACGTGAAAATAAAGAA
TATCCACCATGATTAGACTC -> ATCCACCATGATTAGACTCG
GTCGTACCTGGCAACCCGCC -> TCGTACCTGGCAACCCGCCC
TCAAACAGGAGGGGTCCCCG -> CAAACAGGAGGGGTCCCCGG
TACCCTAAATAAACATGTAA -> ACCCTAAATAAACATGTAAC
CGAGAGAGTCGTACCTGGCA -> GAGAGAGTCGTACCTGGCAA
CTGCATGTGGCCTCTTTTAG -> TGCATGTGGCCTCTTTTAGT
ACGAGAAACAACATTAAGCG -> CGAGAAACAACATTAAGCGA
ATGTTTAGTGTGAGTTTCTA -> TGTTTAGTGTGAGTTTCTAC
ATTCTGTTTGACATGACCTG -> TTCTGTTTGACATGACCTGT
ATTCTAAAGTACAGACCAGT -> TTCTAAAGTACAGACCAGTT
TGTGACTATGTTTAGTGTGA -> GTGACTATGTTTAGTGTGAG
CATCTTAGTATTGCCGCCGG -> ATCTTAGTATTGCCGCCGGC
CCCGCGCCCCTACCTGGATC -> CCGCGCCCCTACCTGGATCT
CCCTCACCTTTGCCAGGCGA -> CCTCACCTTTGCCAGGCGAC
AGGGGCAAGCATGCGATTAA -> GGGGCAAGCATGCGATTAAT
GTAGGATACAGGGGCAAGCA -> TAGGATACAGGGGCAAGCAT
CTTTGCCAGGCGACGCACTG -> TTTGCCAGGCGACGCACTGG
CATCCCCGAAGTCCTAAGGT -> ATCCCCGAAGTCCTAAGGTG
TCCTCACGTAATATTAACCC -> CCTCACGTAATATTAACCCA
AAGCATGCGATTAATTTGAA -> AGCATGCGATTAATTTGAAA
AAAATAAAGAAGGTTAGGAG -> AAATAAAGAAGGTTAGGAGT
GTACAGACCAGTTCCGGATT -> TACAGACCAGTTCCGGATTG
GCAGCGTCATCCCCGAAGTC -> CAGCGTCATCCCCGAAGTCC
CTATAGAGCCATTCTAACCA -> TATAGAGCCATTCTAACCAT
GCTTATGCGGTTATTCTCGC -> CTTATGCGGTTATTCTCGCG
TGCCAGGCGACGCACTGGAA -> GCCAGGCGACGCACTGGAAT
GCTACGGGATGCCCCGAAAT -> CTACGGGATGCCCCGAAATC
CTCGCATCGCAACAAGACAG -> TCGCATCGCAACAAGACAGC
AATTCCTCACGTAATATTAA -> ATTCCTCACGTAATATTAAC
TACAGACCAGTTCCGGATTG -> ACAGACCAGTTCCGGATTGC
CGTAATATTAACCCAGTAAT -> GTAATATTAACCCAGTAATG
AGCCTAGTCGCGGGGGCTGT -> GCCTAGTCGCGGGGGCTGTA
TCAGCTGCATGTGGCCTCTT -> CAGCTGCATGTGGCCTCTTT
AGTATCCACCATGATTAGAC -> GTATCCACCATGATTAGACT
GTACTATAGAGCCATTCTAA -> TACTATAGAGCCATTCTAAC
GAGAAAAATTCTGTTTGACA -> AGAAAAATTCTGTTTGACAT
CCTGGCAACCCGCCCTTCCT -> CTGGCAACCCGCCCTTCCTG
TCATTTAGACTTTAACGAAT -> CATTTAGACTTTAACGAATT
TCCACCATGATTAGACTCGT -> CCACCATGATTAGACTCGTA
TTGCCAGGCGACGCACTGGA -> TGCCAGGCGACGCACTGGAA
GATTGCCCTCACCTTTGCCA -> ATTGCCCTCACCTTTGCCAG
CAGCGTCATCCCCGAAGTCC -> AGCGTCATCCCCGAAGTCCT
TCAAAATCGCAGGAACGGAG -> CAAAATCGCAGGAACGGAGC
TTCCTCACGTAATATTAACC -> TCCTCACGTAATATTAACCC
ATACGAGAAGAGCGAGTTTT -> TACGAGAAGAGCGAGTTTTT
TTGCAGACCGCGCTATCCCC -> TGCAGACCGCGCTATCCCCA
GGGTAGCAACCGGCTTACTA -> GGTAGCAACCGGCTTACTAT
AACAGGTCGACGTGAAAATA -> ACAGGTCGACGTGAAAATAA
GCTTGAGCTAGTGAGAAAAA -> CTTGAGCTAGTGAGAAAAAT
GACGCACTGGAATACGAGAA -> ACGCACTGGAATACGAGAAG
ATTTCAAAATCGCAGGAACG -> TTTCAAAATCGCAGGAACGG
GAAGAGCGAGTTTTTCAGCT -> AAGAGCGAGTTTTTCAGCTT
TCTACGAGAAACAACATTAA -> CTACGAGAAACAACATTAAG
GTCATTTAGACTTTAACGAA -> TCATTTAGACTTTAACGAAT
GCTTGACCTCTATTGGGTAG -> CTTGACCTCTATTGGGTAGC
CGTAACACATTCTAAAGTAC -> GTAACACATTCTAAAGTACA
TCGCATCGCAACAAGACAGC -> CGCATCGCAACAAGACAGCC
ACGGCATTATATCTTGCTGT -> CGGCATTATATCTTGCTGTT
CCGGCTAGTACACTTGACGA -> CGGCTAGTACACTTGACGAT
AACGGAGCGTCAAACAGGAG -> ACGGAGCGTCAAACAGGAGG
TCTGCGCACGAAGGACGTAT -> CTGCGCACGAAGGACGTATC
GTCGCGGGGGCTGTATCGCC -> TCGCGGGGGCTGTATCGCCC
AACGGTAAGTCGCCGATGCT -> ACGGTAAGTCGCCGATGCTT
TCGCAGGAACGGAGCGTCAA -> CGCAGGAACGGAGCGTCAAA
CCAGTTCCGGATTGCCCTCA -> CAGTTCCGGATTGCCCTCAC
CACTGGAATACGAGAAGAGC -> ACTGGAATACGAGAAGAGCG
TAAGTTAGTGTGACTATGTT -> AAGTTAGTGTGACTATGTTT
TGGAACAGGTCGACGTGAAA -> GGAACAGGTCGACGTGAAAA
TTCCTGACAGAATTTCAAAA -> TCCTGACAGAATTTCAAAAT
ACGAGAAGAGCGAGTTTTTC -> CGAGAAGAGCGAGTTTTTCA
TCAGCTTCCACCAGACCATC -> CAGCTTCCACCAGACCATCT
CATTAACAGTTAAGGTACTA -> ATTAACAGTTAAGGTACTAT
CTTGACCTCTATTGGGTAGC -> TTGACCTCTATTGGGTAGCA
GACGTATCAGTCATTTAGAC -> ACGTATCAGTCATTTAGACT
TATTAACCCAGTAATGCTAA -> ATTAACCCAGTAATGCTAAG
ACTTTTAGAGGGACATTCTA -> CTTTTAGAGGGACATTCTAC
CGAACGGCATTATATCTTGC -> GAACGGCATTATATCTTGCT
CGCCTTGAGGCTTAATTCCT -> GCCTTGAGGCTTAATTCCTC
GGCATTATATCTTGCTGTTA -> GCATTATATCTTGCTGTTAA
AATAAAGAAGGTTAGGAGTG -> ATAAAGAAGGTTAGGAGTGT
GACGTGAAAATAAAGAAGGT -> ACGTGAAAATAAAGAAGGTT
CGAGAAACAACATTAAGCGA -> GAGAAACAACATTAAGCGAG
CCCTACCTGGATCTCGCATC -> CCTACCTGGATCTCGCATCG
AGCTACGGGATGCCCCGAAA -> GCTACGGGATGCCCCGAAAT
CCATCTAAGTTAGTGTGACT -> CATCTAAGTTAGTGTGACTA
GCGAGTTTTTCAGCTTCCAC -> CGAGTTTTTCAGCTTCCACC
GAGAATGACTTGCAGCGTCA -> AGAATGACTTGCAGCGTCAT
CCATTTAGCTTATGCGGTTA -> CATTTAGCTTATGCGGTTAT
GGTACTATAGAGCCATTCTA -> GTACTATAGAGCCATTCTAA
CCTCCATTTAGCTTATGCGG -> CTCCATTTAGCTTATGCGGT
TTAGTGTGAGTTTCTACCCT -> TAGTGTGAGTTTCTACCCTA
TAAAGAAGGTTAGGAGTGTT -> AAAGAAGGTTAGGAGTGTTA
TAGGCGCACTTTTAGAGGGA -> AGGCGCACTTTTAGAGGGAC
AAGTACAGACCAGTTCCGGA -> AGTACAGACCAGTTCCGGAT
ACCAGTTCCGGATTGCCCTC -> CCAGTTCCGGATTGCCCTCA
CGTTCGCCTTGAGGCTTAAT -> GTTCGCCTTGAGGCTTAATT
GCCTCTTACTTTACTTCACT -> CCTCTTACTTTACTTCACTA
TGACCTCTATTGGGTAGCAA -> GACCTCTATTGGGTAGCAAC
GACCTGTCAATAGGCGCACT -> ACCTGTCAATAGGCGCACTT
AAGTCCTAAGGTGGAACAGG -> AGTCCTAAGGTGGAACAGGT
GGGACATTCTACGAGAAACA -> GGACATTCTACGAGAAACAA
GCGGGCCATCTGCGCACGAA -> CGGGCCATCTGCGCACGAAG
AAGTTAGTGTGACTATGTTT -> AGTTAGTGTGACTATGTTTA
GCAGACCGCGCTATCCCCAT -> CAGACCGCGCTATCCCCATT
GTAACCAAAATGCTTGACCT -> TAACCAAAATGCTTGACCTC
CAGAATTTCAAAATCGCAGG -> AGAATTTCAAAATCGCAGGA
CTACGGGATGCCCCGAAATC -> TACGGGATGCCCCGAAATCA
AATTTCAAAATCGCAGGAAC -> ATTTCAAAATCGCAGGAACG
CCCCGAAGTCCTAAGGTGGA -> CCCGAAGTCCTAAGGTGGAA
AGTCCTAAGGTGGAACAGGT -> GTCCTAAGGTGGAACAGGTC
TAAAGTTCCTAGACCCCGGT -> AAAGTTCCTAGACCCCGGTA
TAGCTTATGCGGTTATTCTC -> AGCTTATGCGGTTATTCTCG
GCGATTAATTTGAAACGGTA -> CGATTAATTTGAAACGGTAA
TGCCCCGAAATCATGAGAAT -> GCCCCGAAATCATGAGAATG
AATAAACATGTAACCAAAAT -> ATAAACATGTAACCAAAATG
ATGACTTGCAGCGTCATCCC -> TGACTTGCAGCGTCATCCCC
GTCAACGACACCTCCATTTA -> TCAACGACACCTCCATTTAG
GAGGGGTCCCCGGCAGGTTG -> AGGGGTCCCCGGCAGGTTGC
CTTTACTTCACTACGCATGG -> TTTACTTCACTACGCATGGC
CTAAGTTAGTGTGACTATGT -> TAAGTTAGTGTGACTATGTT
GTCGCCGATGCTTGAGCTAG -> TCGCCGATGCTTGAGCTAGT
CCGCGCCCCTACCTGGATCT -> CGCGCCCCTACCTGGATCTC
ACATTCTAAAGTACAGACCA -> CATTCTAAAGTACAGACCAG
CTGCGCACGAAGGACGTATC -> TGCGCACGAAGGACGTATCA
CTCCATTTAGCTTATGCGGT -> TCCATTTAGCTTATGCGGTT
GGATTGCCCTCACCTTTGCC -> GATTGCCCTCACCTTTGCCA
TAGTGTGACTATGTTTAGTG -> AGTGTGACTATGTTTAGTGT
TGGCAACCCGCCCTTCCTGA -> GGCAACCCGCCCTTCCTGAC
ATCAGTCATTTAGACTTTAA -> TCAGTCATTTAGACTTTAAC
CTACCCTAAATAAACATGTA -> TACCCTAAATAAACATGTAA
GGAACAGGTCGACGTGAAAA -> GAACAGGTCGACGTGAAAAT
AGAGAGTCGTACCTGGCAAC -> GAGAGTCGTACCTGGCAACC
TCATGAGAATGACTTGCAGC -> CATGAGAATGACTTGCAGCG
AAACGGTAAGTCGCCGATGC -> AACGGTAAGTCGCCGATGCT
ATCGCCCGAGAGAGTCGTAC -> TCGCCCGAGAGAGTCGTACC
ACCTGTCAATAGGCGCACTT -> CCTGTCAATAGGCGCACTTT
AATGGAGTTAGTTACACCCG -> ATGGAGTTAGTTACACCCGC
CCTAAGGTGGAACAGGTCGA -> CTAAGGTGGAACAGGTCGAC
TGAGCTAGTGAGAAAAATTC -> GAGCTAGTGAGAAAAATTCT
CTCTTACTTTACTTCACTAC -> TCTTACTTTACTTCACTACG
TCCGGATTGCCCTCACCTTT -> CCGGATTGCCCTCACCTTTG
CCTCACCTTTGCCAGGCGAC -> CTCACCTTTGCCAGGCGACG
ATGATTAGACTCGTAACACA -> TGATTAGACTCGTAACACAT
TGACAGAATTTCAAAATCGC -> GACAGAATTTCAAAATCGCA
GCTGTATCGCCCGAGAGAGT -> CTGTATCGCCCGAGAGAGTC
TAGTATCCACCATGATTAGA -> AGTATCCACCATGATTAGAC
AAACATGTAACCAAAATGCT -> AACATGTAACCAAAATGCTT
GTCATCCCCGAAGTCCTAAG -> TCATCCCCGAAGTCCTAAGG
ACACCCGCGCCCCTACCTGG -> CACCCGCGCCCCTACCTGGA
TGCGCACGAAGGACGTATCA -> GCGCACGAAGGACGTATCAG
GCGTTCGCCTTGAGGCTTAA -> CGTTCGCCTTGAGGCTTAAT
GGGCTGTATCGCCCGAGAGA -> GGCTGTATCGCCCGAGAGAG
GGTTAGGAGTGTTAAAGTTC -> GTTAGGAGTGTTAAAGTTCC
CTTGCTGTTAAGCGCCAGCC -> TTGCTGTTAAGCGCCAGCCT
TTTAACGAATTGCAGACCGC -> TTAACGAATTGCAGACCGCG
CTCAGCTGCATGTGGCCTCT -> TCAGCTGCATGTGGCCTCTT
ACAAGACAGCCTAGTCGCGG -> CAAGACAGCCTAGTCGCGGG
TTAGTTACACCCGCGCCCCT -> TAGTTACACCCGCGCCCCTA
ACCAAAATGCTTGACCTCTA -> CCAAAATGCTTGACCTCTAT
AACATTAAGCGAGTTACGAA -> ACATTAAGCGAGTTACGAAT
GAACGGAGCGTCAAACAGGA -> AACGGAGCGTCAAACAGGAG
TCTACCCTAAATAAACATGT -> CTACCCTAAATAAACATGTA
TTAACCCAGTAATGCTAAGC -> TAACCCAGTAATGCTAAGCT
AGGAACGGAGCGTCAAACAG -> GGAACGGAGCGTCAAACAGG
TCTCAGCTGCATGTGGCCTC -> CTCAGCTGCATGTGGCCTCT
CTTAGTATTGCCGCCGGCTA -> TTAGTATTGCCGCCGGCTAG
TAGACTCGTAACACATTCTA -> AGACTCGTAACACATTCTAA
AGTACACTTGACGATGAAGC -> GTACACTTGACGATGAAGCA
CCTTTGCCAGGCGACGCACT -> CTTTGCCAGGCGACGCACTG
CGCACGAAGGACGTATCAGT -> GCACGAAGGACGTATCAGTC
TAGTGAGAAAAATTCTGTTT -> AGTGAGAAAAATTCTGTTTG
GTGAAAATAAAGAAGGTTAG -> TGAAAATAAAGAAGGTTAGG
GAGCTAGTGAGAAAAATTCT -> AGCTAGTGAGAAAAATTCTG
CAATAGGCGCACTTTTAGAG -> AATAGGCGCACTTTTAGAGG
CGAATGGAGTTAGTTACACC -> GAATGGAGTTAGTTACACCC
ATTGGGTAGCAACCGGCTTA -> TTGGGTAGCAACCGGCTTAC
AAAGTTCCTAGACCCCGGTA -> AAGTTCCTAGACCCCGGTAG
CCCGAGAGAGTCGTACCTGG -> CCGAGAGAGTCGTACCTGGC
TTGACATGACCTGTCAATAG -> TGACATGACCTGTCAATAGG
AGGAGGGGTCCCCGGCAGGT -> GGAGGGGTCCCCGGCAGGTT
ACGTGAAAATAAAGAAGGTT -> CGTGAAAATAAAGAAGGTTA
ATCTTAGTATTGCCGCCGGC -> TCTTAGTATTGCCGCCGGCT
ACTGGAATACGAGAAGAGCG -> CTGGAATACGAGAAGAGCGA
ATCTTGCTGTTAAGCGCCAG -> TCTTGCTGTTAAGCGCCAGC
TACCTGGATCTCGCATCGCA -> ACCTGGATCTCGCATCGCAA
CGAAGGACGTATCAGTCATT -> GAAGGACGTATCAGTCATTT
ATTTAGACTTTAACGAATTG -> TTTAGACTTTAACGAATTGC
GGAGTTAGTTACACCCGCGC -> GAGTTAGTTACACCCGCGCC
TAGTCGCGGGGGCTGTATCG -> AGTCGCGGGGGCTGTATCGC
GTGTGACTATGTTTAGTGTG -> TGTGACTATGTTTAGTGTGA
GCTTAATTCCTCACGTAATA -> CTTAATTCCTCACGTAATAT
AGCTAGTGAGAAAAATTCTG -> GCTAGTGAGAAAAATTCTGT
TGGATCTCGCATCGCAACAA -> GGATCTCGCATCGCAACAAG
ACGATGAAGCATTAACAGTT -> CGATGAAGCATTAACAGTTA
GCATTATATCTTGCTGTTAA -> CATTATATCTTGCTGTTAAG
CCGCCCTTCCTGACAGAATT -> CGCCCTTCCTGACAGAATTT
GTACCTGGCAACCCGCCCTT -> TACCTGGCAACCCGCCCTTC
GGGCCATCTGCGCACGAAGG -> GGCCATCTGCGCACGAAGGA
GGTAGGATACAGGGGCAAGC -> GTAGGATACAGGGGCAAGCA
CTCTTTTAGTATCCACCATG -> TCTTTTAGTATCCACCATGA
CAGGCGACGCACTGGAATAC -> AGGCGACGCACTGGAATACG
GTGAGTTTCTACCCTAAATA -> TGAGTTTCTACCCTAAATAA
TAACAGTTAAGGTACTATAG -> AACAGTTAAGGTACTATAGA
CGGCAGGTTGCTCTCAGCTG -> GGCAGGTTGCTCTCAGCTGC
TCACCTTTGCCAGGCGACGC -> CACCTTTGCCAGGCGACGCA
TGTCAACGACACCTCCATTT -> GTCAACGACACCTCCATTTA
CAACCGGCTTACTATTGATT -> AACCGGCTTACTATTGATTT
CGAATTGCAGACCGCGCTAT -> GAATTGCAGACCGCGCTATC
CGCGCTATCCCCATTTCCCG -> GCGCTATCCCCATTTCCCGG
GACATTCTACGAGAAACAAC -> ACATTCTACGAGAAACAACA
CACGAAGGACGTATCAGTCA -> ACGAAGGACGTATCAGTCAT
CATTCTAAAGTACAGACCAG -> ATTCTAAAGTACAGACCAGT
GCGCCAGCCTCTTACTTTAC -> CGCCAGCCTCTTACTTTACT
GCAGGTTGCTCTCAGCTGCA -> CAGGTTGCTCTCAGCTGCAT
TTTAGAGGGACATTCTACGA -> TTAGAGGGACATTCTACGAG
CCCGAAGTCCTAAGGTGGAA -> CCGAAGTCCTAAGGTGGAAC
CAGACCGCGCTATCCCCATT -> AGACCGCGCTATCCCCATTT
GGCAACCCGCCCTTCCTGAC -> GCAACCCGCCCTTCCTGACA
GCAACCGGCTTACTATTGAT -> CAACCGGCTTACTATTGATT
CTAACCATCTAAGTTAGTGT -> TAACCATCTAAGTTAGTGTG
CTAAGCTACGGGATGCCCCG -> TAAGCTACGGGATGCCCCGA
ACCTCTATTGGGTAGCAACC -> CCTCTATTGGGTAGCAACCG
CGCACTTTTAGAGGGACATT -> GCACTTTTAGAGGGACATTC
CGTATCAGTCATTTAGACTT -> GTATCAGTCATTTAGACTTT
TAAATAAACATGTAACCAAA -> AAATAAACATGTAACCAAAA
AGAGTCGTACCTGGCAACCC -> GAGTCGTACCTGGCAACCCG
AGCCATTCTAACCATCTAAG -> GCCATTCTAACCATCTAAGT
CGATTAATTTGAAACGGTAA -> GATTAATTTGAAACGGTAAG
GTTTCTACCCTAAATAAACA -> TTTCTACCCTAAATAAACAT
TTGAGCTAGTGAGAAAAATT -> TGAGCTAGTGAGAAAAATTC
ATGTAACCAAAATGCTTGAC -> TGTAACCAAAATGCTTGACC
GGGGCTGTATCGCCCGAGAG -> GGGCTGTATCGCCCGAGAGA
CGAAATCATGAGAATGACTT -> GAAATCATGAGAATGACTTG
CAGGTCGACGTGAAAATAAA -> AGGTCGACGTGAAAATAAAG
CTAGTGAGAAAAATTCTGTT -> TAGTGAGAAAAATTCTGTTT
ATTGCCCTCACCTTTGCCAG -> TTGCCCTCACCTTTGCCAGG
TTATTCTCGCGAACGGCATT -> TATTCTCGCGAACGGCATTA
AGTTCCGGATTGCCCTCACC -> GTTCCGGATTGCCCTCACCT
CCTTGAGGCTTAATTCCTCA -> CTTGAGGCTTAATTCCTCAC
CTATGTTTAGTGTGAGTTTC -> TATGTTTAGTGTGAGTTTCT
CTTTTAGTATCCACCATGAT -> TTTTAGTATCCACCATGATT
GGCTTAATTCCTCACGTAAT -> GCTTAATTCCTCACGTAATA
GACCAGTTCCGGATTGCCCT -> ACCAGTTCCGGATTGCCCTC
TGCGGTTATTCTCGCGAACG -> GCGGTTATTCTCGCGAACGG
AGGACGTATCAGTCATTTAG -> GGACGTATCAGTCATTTAGA
TTTAGTATCCACCATGATTA -> TTAGTATCCACCATGATTAG
CCAAAATGCTTGACCTCTAT -> CAAAATGCTTGACCTCTATT
CATGCGATTAATTTGAAACG -> ATGCGATTAATTTGAAACGG
CCCAGTAATGCTAAGCTACG -> CCAGTAATGCTAAGCTACGG
CCCCATTTCCCGGGTGTCAA -> CCCATTTCCCGGGTGTCAAC
TTTCTACCCTAAATAAACAT -> TTCTACCCTAAATAAACATG
GTATCCACCATGATTAGACT -> TATCCACCATGATTAGACTC
AAGGACGTATCAGTCATTTA -> AGGACGTATCAGTCATTTAG
TCCCGGGTGTCAACGACACC -> CCCGGGTGTCAACGACACCT
GCGGGGGCTGTATCGCCCGA -> CGGGGGCTGTATCGCCCGAG
GGGATGCCCCGAAATCATGA -> GGATGCCCCGAAATCATGAG
ATTATATCTTGCTGTTAAGC -> TTATATCTTGCTGTTAAGCG
GACCCCGGTAGGATACAGGG -> ACCCCGGTAGGATACAGGGG
ACCCAGTAATGCTAAGCTAC -> CCCAGTAATGCTAAGCTACG
AGTGTGAGTTTCTACCCTAA -> GTGTGAGTTTCTACCCTAAA
CCGGATTGCCCTCACCTTTG -> CGGATTGCCCTCACCTTTGC
TTTCAGCTTCCACCAGACCA -> TTCAGCTTCCACCAGACCAT
TTCTAACCATCTAAGTTAGT -> TCTAACCATCTAAGTTAGTG
CGCGGGGGCTGTATCGCCCG -> GCGGGGGCTGTATCGCCCGA
GCTGCATGTGGCCTCTTTTA -> CTGCATGTGGCCTCTTTTAG
TCAACGACACCTCCATTTAG -> CAACGACACCTCCATTTAGC
TAGAGCCATTCTAACCATCT -> AGAGCCATTCTAACCATCTA
CATGATTAGACTCGTAACAC -> ATGATTAGACTCGTAACACA
CAGGAGGGGTCCCCGGCAGG -> AGGAGGGGTCCCCGGCAGGT
CGGAGCGTCAAACAGGAGGG -> GGAGCGTCAAACAGGAGGGG
TCTGTTTGACATGACCTGTC -> CTGTTTGACATGACCTGTCA
GATGCTTGAGCTAGTGAGAA -> ATGCTTGAGCTAGTGAGAAA
TAAGCGAGTTACGAATGGAG -> AAGCGAGTTACGAATGGAGT
TTAACAGTTAAGGTACTATA -> TAACAGTTAAGGTACTATAG
CCCTTCCTGACAGAATTTCA -> CCTTCCTGACAGAATTTCAA
ACATTAAGCGAGTTACGAAT -> CATTAAGCGAGTTACGAATG
TTAAGGTACTATAGAGCCAT -> TAAGGTACTATAGAGCCATT
ACTATGTTTAGTGTGAGTTT -> CTATGTTTAGTGTGAGTTTC
TGACATGACCTGTCAATAGG -> GACATGACCTGTCAATAGGC
TGTTTAGTGTGAGTTTCTAC -> GTTTAGTGTGAGTTTCTACC
CCTAGACCCCGGTAGGATAC -> CTAGACCCCGGTAGGATACA
TAATATTAACCCAGTAATGC -> AATATTAACCCAGTAATGCT
CATTTAGCTTATGCGGTTAT -> ATTTAGCTTATGCGGTTATT
TTAGTATTGCCGCCGGCTAG -> TAGTATTGCCGCCGGCTAGT
ACAGCCTAGTCGCGGGGGCT -> CAGCCTAGTCGCGGGGGCTG
CGATGAAGCATTAACAGTTA -> GATGAAGCATTAACAGTTAA
CCTAAATAAACATGTAACCA -> CTAAATAAACATGTAACCAA
TTCAGCTTCCACCAGACCAT -> TCAGCTTCCACCAGACCATC
TAAACATGTAACCAAAATGC -> AAACATGTAACCAAAATGCT
GACATGACCTGTCAATAGGC -> ACATGACCTGTCAATAGGCG
TAAAGTACAGACCAGTTCCG -> AAAGTACAGACCAGTTCCGG
GCCCTTCCTGACAGAATTTC -> CCCTTCCTGACAGAATTTCA
GAATACGAGAAGAGCGAGTT -> AATACGAGAAGAGCGAGTTT
GGATACAGGGGCAAGCATGC -> GATACAGGGGCAAGCATGCG
AGCTGCATGTGGCCTCTTTT -> GCTGCATGTGGCCTCTTTTA
GTAGCAACCGGCTTACTATT -> TAGCAACCGGCTTACTATTG
GCAACCCGCCCTTCCTGACA -> CAACCCGCCCTTCCTGACAG
TTTCCCGGGTGTCAACGACA -> TTCCCGGGTGTCAACGACAC
AAACAACATTAAGCGAGTTA -> AACAACATTAAGCGAGTTAC
CTGGAATACGAGAAGAGCGA -> TGGAATACGAGAAGAGCGAG
GTTAGTGTGACTATGTTTAG -> TTAGTGTGACTATGTTTAGT
AACCGGCTTACTATTGATTT -> ACCGGCTTACTATTGATTTC
ACGAATGGAGTTAGTTACAC -> CGAATGGAGTTAGTTACACC
AGGTACTATAGAGCCATTCT -> GGTACTATAGAGCCATTCTA
CTCACGTAATATTAACCCAG -> TCACGTAATATTAACCCAGT
ACAGTTAAGGTACTATAGAG -> CAGTTAAGGTACTATAGAGC
ACACATTCTAAAGTACAGAC -> CACATTCTAAAGTACAGACC
CAACGACACCTCCATTTAGC -> AACGACACCTCCATTTAGCT
GGCTAGTACACTTGACGATG -> GCTAGTACACTTGACGATGA
GAGAGTCGTACCTGGCAACC -> AGAGTCGTACCTGGCAACCC
GTTTAGTGTGAGTTTCTACC -> TTTAGTGTGAGTTTCTACCC
AAGCTACGGGATGCCCCGAA -> AGCTACGGGATGCCCCGAAA
TCAATAGGCGCACTTTTAGA -> CAATAGGCGCACTTTTAGAG
GCATGGCGTTCGCCTTGAGG -> CATGGCGTTCGCCTTGAGGC
GAGGGACATTCTACGAGAAA -> AGGGACATTCTACGAGAAAC
CGTGAAAATAAAGAAGGTTA -> GTGAAAATAAAGAAGGTTAG
CGGGTGTCAACGACACCTCC -> GGGTGTCAACGACACCTCCA
TATGCGGTTATTCTCGCGAA -> ATGCGGTTATTCTCGCGAAC
TAGTACACTTGACGATGAAG -> AGTACACTTGACGATGAAGC
GCCTTGAGGCTTAATTCCTC -> CCTTGAGGCTTAATTCCTCA
TCTAAGTTAGTGTGACTATG -> CTAAGTTAGTGTGACTATGT
GCTAGTACACTTGACGATGA -> CTAGTACACTTGACGATGAA
TGTTAAAGTTCCTAGACCCC -> GTTAAAGTTCCTAGACCCCG
CTGGCAACCCGCCCTTCCTG -> TGGCAACCCGCCCTTCCTGA
GTATCAGTCATTTAGACTTT -> TATCAGTCATTTAGACTTTA
TAAGCGCCAGCCTCTTACTT -> AAGCGCCAGCCTCTTACTTT
GTACACTTGACGATGAAGCA -> TACACTTGACGATGAAGCAT
GCACTGGAATACGAGAAGAG -> CACTGGAATACGAGAAGAGC
TTCACTACGCATGGCGTTCG -> TCACTACGCATGGCGTTCGC
TCCCCGAAGTCCTAAGGTGG -> CCCCGAAGTCCTAAGGTGGA
CCTAGTCGCGGGGGCTGTAT -> CTAGTCGCGGGGGCTGTATC
CAGTAATGCTAAGCTACGGG -> AGTAATGCTAAGCTACGGGA
TTGCTGTTAAGCGCCAGCCT -> TGCTGTTAAGCGCCAGCCTC
ACAGAATTTCAAAATCGCAG -> CAGAATTTCAAAATCGCAGG
CGTCAAACAGGAGGGGTCCC -> GTCAAACAGGAGGGGTCCCC
GTATTGCCGCCGGCTAGTAC -> TATTGCCGCCGGCTAGTACA
ATAAAGAAGGTTAGGAGTGT -> TAAAGAAGGTTAGGAGTGTT
CAGGAACGGAGCGTCAAACA -> AGGAACGGAGCGTCAAACAG
TTTACTTCACTACGCATGGC -> TTACTTCACTACGCATGGCG
TCTTGCTGTTAAGCGCCAGC -> CTTGCTGTTAAGCGCCAGCC
CGTACCTGGCAACCCGCCCT -> GTACCTGGCAACCCGCCCTT
TACAGGGGCAAGCATGCGAT -> ACAGGGGCAAGCATGCGATT
GCAAGCATGCGATTAATTTG -> CAAGCATGCGATTAATTTGA
GTTTGACATGACCTGTCAAT -> TTTGACATGACCTGTCAATA
AGTCGCGGGGGCTGTATCGC -> GTCGCGGGGGCTGTATCGCC
ATCTAAGTTAGTGTGACTAT -> TCTAAGTTAGTGTGACTATG
CGCGGGCCATCTGCGCACGA -> GCGGGCCATCTGCGCACGAA
CTCGTAACACATTCTAAAGT -> TCGTAACACATTCTAAAGTA
TAAGTCGCCGATGCTTGAGC -> AAGTCGCCGATGCTTGAGCT
ACTCGTAACACATTCTAAAG -> CTCGTAACACATTCTAAAGT
GGCTGTATCGCCCGAGAGAG -> GCTGTATCGCCCGAGAGAGT
GGAGCGTCAAACAGGAGGGG -> GAGCGTCAAACAGGAGGGGT
